abandon -> abandons,abandoning,abandoned
abase -> abases,abasing,abased
abate -> abates,abating,abated
abbreviate -> abbreviates,abbreviating,abbreviated
abdicate -> abdicates,abdicating,abdicated
abduct -> abducts,abducting,abducted
abet -> abets,abetting,abetted
abhor -> abhors,abhorring,abhorred
abide -> abode,abided,abides,abiding
abjure -> abjures,abjuring,abjured
abolish -> abolishes,abolishing,abolished
abominate -> abominates,abominating,abominated
abort -> aborts,aborting,aborted
abound -> abounds,abounding,abounded
abridge -> abridges,abridging,abridged
abrogate -> abrogates,abrogating,abrogated
abscond -> absconds,absconding,absconded
abseil -> abseils,abseiling,abseiled
absent -> absents,absenting,absented
absolve -> absolves,absolving,absolved
absorb -> absorbs,absorbing,absorbed
abstain -> abstains,abstaining,abstained
abstract -> abstracts,abstracting,abstracted
abuse -> abuses,abusing,abused
abut -> abuts,abutting,abutted
accede -> accedes,acceding,acceded
accelerate -> accelerates,accelerating,accelerated
accent -> accents,accenting,accented
accentuate -> accentuates,accentuating,accentuated
accept -> accepts,accepting,accepted
access -> accesses,accessing,accessed
acclaim -> acclaims,acclaiming,acclaimed
acclimatize -> acclimatizes,acclimatizing,acclimatized
accommodate -> accommodates,accommodating,accommodated
accompany -> accompanies,accompanying,accompanied
accomplish -> accomplishes,accomplishing,accomplished
accord -> accords,according,accorded
accost -> accosts,accosting,accosted
account -> accounts,accounting,accounted
accredit -> accredits,accrediting,accredited
accrue -> accrues,accruing,accrued
accumulate -> accumulates,accumulating,accumulated
accuse -> accuses,accusing,accused
accustom -> accustoms,accustoming,accustomed
ache -> aches,aching,ached
achieve -> achieves,achieving,achieved
acknowledge -> acknowledges,acknowledging,acknowledged
acquaint -> acquaints,acquainting,acquainted
acquiesce -> acquiesces,acquiescing,acquiesced
acquire -> acquires,acquiring,acquired
acquit -> acquits,acquitting,acquitted
act -> acts,acting,acted
activate -> activates,activating,activated
actuate -> actuates,actuating,actuated
ad-lib -> ad-libs,ad-libbing,ad-libbed
adapt -> adapts,adapting,adapted
add -> adds,adding,added
addle -> addles,addling,addled
address -> addresses,addressing,addressed
adduce -> adduces,adducing,adduced
adhere -> adheres,adhering,adhered
adjoin -> adjoins,adjoining,adjoined
adjourn -> adjourns,adjourning,adjourned
adjudge -> adjudges,adjudging,adjudged
adjudicate -> adjudicates,adjudicating,adjudicated
adjure -> adjures,adjuring,adjured
adjust -> adjusts,adjusting,adjusted
administer -> administers,administering,administered
admire -> admires,admiring,admired
admit -> admits,admitting,admitted
admonish -> admonishes,admonishing,admonished
adopt -> adopts,adopting,adopted
adore -> adores,adoring,adored
adorn -> adorns,adorning,adorned
adulterate -> adulterates,adulterating,adulterated
advance -> advances,advancing,advanced
advertise -> advertises,advertising,advertised
advise -> advises,advising,advised
advocate -> advocates,advocating,advocated
aerate -> aerates,aerating,aerated
affect -> affects,affecting,affected
affiliate -> affiliates,affiliating,affiliated
affirm -> affirms,affirming,affirmed
affix -> affixes,affixing,affixed
afflict -> afflicts,afflicting,afflicted
afford -> affords,affording,afforded
affront -> affronts,affronting,affronted
age -> ages,ageing,aged
aggravate -> aggravates,aggravating,aggravated
aggregate -> aggregates,aggregating,aggregated.
agitate -> agitates,agitating,agitated
agonize -> agonizes,agonizing,agonized
agree -> agrees,agreeing,agreed
aid -> aids,aiding,aided
ail -> ails,ailing,ailed
aim -> aims,aiming,aimed
air -> airs,airing,aired
airlift -> airlifts,airlifting,airlifted
alarm -> alarms,alarming,alarmed
alert -> alerts,alerting,alerted
alienate -> alienates,alienating,alienated
alight -> alights,alighting,alighted,alit
align -> aligns,aligning,aligned
allay -> allays,allaying,allayed
allege -> alleges,alleging,alleged
alleviate -> alleviates,alleviating,alleviated
allocate -> allocates,allocating,allocated
allot -> allots,allotting,allotted
allow -> allows,allowing,allowed
allude -> alludes,alluding,alluded
ally -> allies,allying,allied
alter -> alters,altering,altered
alternate -> alternates,alternating,alternated
amalgamate -> amalgamates,amalgamating,amalgamated
amass -> amasses,amassing,amassed
amaze -> amazes,amazing,amazed
amble -> ambles,ambling,ambled
ambush -> ambushes,ambushing,ambushed
ameliorate -> ameliorates,ameliorating,ameliorated
amend -> amends,amending,amended
Americanize -> Americanizes,Americanizing,Americanized
amount -> amounts,amounting,amounted
amplify -> amplifies,amplifying,amplified
amputate -> amputates,amputating,amputated
amuse -> amuses,amusing,amused
anaesthetize -> anaesthetizes,anaesthetizing,anaesthetized
analyse -> analyses,analysing,analysed
anchor -> anchors,anchoring,anchored
anesthetize -> anesthetizes,anesthetizing,anesthetized
anger -> angers,angering,angered
angle -> angles,angling,angled
anglicize -> anglicizes,anglicizing,anglicized
animate -> animates,animating,animated
annex -> annexes,annexing,annexed
annihilate -> annihilates,annihilating,annihilated
annotate -> annotates,annotating,annotated
announce -> announces,announcing,announced
annoy -> annoys,annoying,annoyed
annul -> annuls,annulling,annulled
anoint -> anoints,anointing,anointed
answer -> answers,answering,answered
antagonize -> antagonizes,antagonizing,antagonized
antedate -> antedates,antedating,antedated
anticipate -> anticipates,anticipating,anticipated
ape -> apes,aping,aped
apologize -> apologizes,apologizing,apologized
appal -> appals,appalling,appalled
appeal -> appeals,appealing,appealed
appear -> appears,appearing,appeared
appease -> appeases,appeasing,appeased
append -> appends,appending,appended
appertain -> appertains,appertaining,appertained
applaud -> applauds,applauding,applauded
apply -> applies,applying,applied
appoint -> appoints,appointing,appointed
apportion -> apportions,apportioning,apportioned
appraise -> appraises,appraising,appraised
appreciate -> appreciates,appreciating,appreciated
apprehend -> apprehends,apprehending,apprehended
apprentice -> apprentices,apprenticing,apprenticed
apprise -> apprises,apprising,apprised
approach -> approaches,approaching,approached
appropriate -> appropriates,appropriating,appropriated
approve -> approves,approving,approved
approximate -> approximates,approximating,approximated
arbitrate -> arbitrates,arbitrating,arbitrated
arc -> arcs,arcing,arced
arch -> arches,arching,arched
argue -> argues,arguing,argued
arise -> arises,arising,arose,arisen
arm -> arms,arming,armed
arouse -> arouses,arousing,aroused
arraign -> arraigns,arraigning,arraigned
arrange -> arranges,arranging,arranged
array -> arrays,arraying,arrayed
arrest -> arrests,arresting,arrested
arrive -> arrives,arriving,arrived
arrogate -> arrogates,arrogating,arrogated
arse -> arses,arsing,arsed
articulate -> articulates,articulating,articulated
ascend -> ascends,ascending,ascended
ascertain -> ascertains,ascertaining,ascertained
ascribe -> ascribes,ascribing,ascribed
ask -> asks,asking,asked
asphalt -> asphalts,asphalting,asphalted
asphyxiate -> asphyxiates,asphyxiating,asphyxiated
aspirate -> aspirates,aspirating,aspirated
aspire -> aspires,aspiring,aspired
assail -> assails,assailing,assailed
assassinate -> assassinates,assassinating,assassinated
assault -> assaults,assaulting,assaulted
assay -> assays,assaying,assayed
assemble -> assembles,assembling,assembled
assent -> assents,assenting,assented
assert -> asserts,asserting,asserted
assess -> assesses,assessing,assessed
assign -> assigns,assigning,assigned
assimilate -> assimilates,assimilating,assimilated
assist -> assists,assisting,assisted
associate -> associates,associating,associated
assuage -> assuages,assuaging,assuaged
assume -> assumes,assuming,assumed
assure -> assures,assuring,assured
asterisk -> asterisks,asterisking,asterisked
astonish -> astonishes,astonishing,astonished
astound -> astounds,astounding,astounded
atomize -> atomizes,atomizing,atomized
atone -> atones,atoning,atoned
atrophy -> atrophies,atrophying,atrophied
attach -> attaches,attaching,attached
attack -> attacks,attacking,attacked
attain -> attains,attaining,attained
attempt -> attempts,attempting,attempted
attend -> attends,attending,attended
attenuate -> attenuates,attenuating,attenuated
attest -> attests,attesting,attested
attract -> attracts,attracting,attracted
attribute -> attributes,attributing,attributed
auction -> auctions,auctioning,auctioned
audit -> audits,auditing,audited
audition -> auditions,auditioning,auditioned
augment -> augments,augmenting,augmented
augur -> augurs,auguring,augured
authenticate -> authenticates,authenticating,authenticated
author -> authors,authoring,authored
authorize -> authorizes,authorizing,authorized
autograph -> autographs,autographing,autographed
automate -> automates,automating,automated
avail -> avails,availing,availed
avenge -> avenges,avenging,avenged
aver -> avers,averring,averred
average -> averages,averaging,averaged
avert -> averts,averting,averted
avoid -> avoids,avoiding,avoided
avow -> avows,avowing,avowed
await -> awaits,awaiting,awaited
awake -> awakes,awaking,awoke,awoken
awaken -> awakens,awakening,awakened
award -> awards,awarding,awarded
axe -> axes,axing,axed
babble -> babbles,babbling,babbled
baby-sit -> baby-sits,baby-sitting,baby-sat
back -> backs,backing,backed
back-comb -> back-combs,back-combing,back-combed
back-pedal -> back-pedals,back-pedalling,back-pedalled
backbite -> backbites,backbit,backbitten,backbiting
backdate -> backdates,backdating,backdated
backfire -> backfires,backfiring,backfired
backslide -> backslides,backslid,backsliding,backslidden
backtrack -> backtracks,backtracking,backtracked
badger -> badgers,badgering,badgered
baffle -> baffles,baffling,baffled
bag -> bags,bagging,bagged
bail -> bails,bailing,bailed
bait -> baits,baiting,baited
bake -> bakes,baking,baked
balance -> balances,balancing,balanced
bale -> bales,baling,baled
balk -> balks,balking,balked
ball -> balls,balling,balled
balloon -> balloons,ballooning,ballooned
ballot -> ballots,balloting,balloted
bamboozle -> bamboozles,bamboozling,bamboozled
ban -> bans,banning,banned
band -> bands,banding,banded
bandage -> bandages,bandaging,bandaged
bandy -> bandies,bandying,bandied
bang -> bangs,banging,banged
banish -> banishes,banishing,banished
bank -> banks,banking,banked
bankroll -> bankrolls,bankrolling,bankrolled
bankrupt -> bankrupts,bankrupting,bankrupted
banter -> banters,bantering,bantered
baptize -> baptizes,baptizing,baptized
bar -> bars,barring,barred
barbecue -> barbecues,barbecuing,barbecued
barber -> barbers,barbering,barbered
bare -> barer,barest,bares,baring,bared
bargain -> bargains,bargaining,bargained
barge -> barges,barging,barged
bark -> barks,barking,barked
barrack -> barracks,barracking,barracked
barricade -> barricades,barricading,barricaded
barter -> barters,bartering,bartered
base -> bases,basing,based,baser,basest
bash -> bashes,bashing,bashed
bask -> basks,basking,basked
baste -> bastes,basting,basted
bat -> bats,batting,batted
bath -> baths,bathing,bathed
bathe -> bathes,bathing,bathed
batten -> battens,battening,battened
batter -> batters,battering,battered
battle -> battles,battling,battled
bawl -> bawls,bawling,bawled
bay -> bays,baying,bayed
bayonet -> bayonets,bayoneting,bayoneted
be -> am,are,is,was,were,being,been,'m,m
beach -> beaches,beaching,beached
beam -> beams,beaming,beamed
bear -> bears,bearing,bore,borne
beat -> beats,beating,beaten
beatify -> beatifies,beatifying,beatified
beautify -> beautifies,beautifying,beautified
beckon -> beckons,beckoning,beckoned
become -> becomes,becoming,became
bed -> beds,bedding,bedded
bedeck -> bedecks,bedecking,bedecked
bedevil -> bedevils,bedevilling,bedevilled
beef -> beefs,beefing,beefed
beep -> beeps,beeping,beeped
beetle -> beetles,beetling,beetled
befall -> befalls,befalling,befell,befallen
befit -> befits,befitting,befitted
befriend -> befriends,befriending,befriended
befuddle -> befuddles,befuddling,befuddled
beg -> begs,begging,begged
beget -> begets,begetting,begot,begotten
beggar -> beggars,beggaring,beggared
begin -> begins,beginning,began,begun
begrudge -> begrudges,begrudging,begrudged
beguile -> beguiles,beguiling,beguiled
behave -> behaves,behaving,behaved
behead -> beheads,beheading,beheaded
behold -> beholds,beholding,beheld
behove -> behoves,behoving,behoved
belabour -> belabours,belabouring,belaboured
belch -> belches,belching,belched
belie -> belies,belying,belied
believe -> believes,believing,believed
belittle -> belittles,belittling,belittled
bellow -> bellows,bellowing,bellowed
belly -> bellies,bellying,bellied
bellyache -> bellyaches,bellyaching,bellyached
belong -> belongs,belonging,belonged
belt -> belts,belting,belted
bemoan -> bemoans,bemoaning,bemoaned
bend -> bends,bending,bent
benefit -> benefits,benefiting,benefited
bequeath -> bequeaths,bequeathing,bequeathed
berate -> berates,berating,berated
bereave -> bereaves,bereft,bereaved,bereaving
berth -> berths,berthing,berthed
beseech -> beseeches,beseeching,beseeched,besought
besiege -> besieges,besieging,besieged
besmirch -> besmirches,besmirching,besmirched
bespeak -> bespeaks,bespeaking,bespoke,bespoken
bestir -> bestirs,bestirring,bestirred
bestow -> bestows,bestowing,bestowed
bestrew -> bestrewed,bestrewn,bestrews,bestrewing
bestride -> bestrides,bestrode,bestrid,bestridden,bestriding
bet -> bets,betted,betting
betake -> betakes,betook,betaken,betaking
bethink -> bethinks,bethought,bethinking
betoken -> betokens,betokening,betokened
betray -> betrays,betraying,betrayed
better -> betters,bettering,bettered
bewail -> bewails,bewailing,bewailed
bewilder -> bewilders,bewildering,bewildered
bewitch -> bewitches,bewitching,bewitched
bias -> biases,biasing,biased
bicker -> bickers,bickering,bickered
bicycle -> bicycles,bicycling,bicycled
bide -> bides,bode,bided,biding
biff -> biffs,biffing,biffed
bill -> bills,billing,billed
billet -> billets,billeting,billeted
billow -> billows,billowing,billowed
bind -> binds,binding,bound
bisect -> bisects,bisecting,bisected
bitch -> bitches,bitching,bitched
bite -> bites,biting,bit,bitten
bivouac -> bivouacs,bivouacking,bivouacked
blab -> blabs,blabbing,blabbed
blabber -> blabbers,blabbering,blabbered
black -> blacker,blackest,blacks,blacking,blacked
blackball -> blackballs,blackballing,blackballed
blacken -> blackens,blackening,blackened
blacklist -> blacklists,blacklisting,blacklisted
blackmail -> blackmails,blackmailing,blackmailed
blame -> blames,blaming,blamed
blanch -> blanches,blanching,blanched
blank -> blanker,blankest,blanks
blanket -> blankets,blanketing,blanketed
blare -> blares,blaring,blared
blaspheme -> blasphemes,blaspheming,blasphemed
blast -> blasts,blasting,blasted
blaze -> blazes,blazing,blazed
blazon -> blazons,blazoning,blazoned
bleach -> bleaches,bleaching,bleached
bleat -> bleats,bleating,bleated
bleed -> bleeds,bleeding,bled
bleep -> bleeps,bleeping,bleeped
blemish -> blemishes,blemishing,blemished
blench -> blenches,blenching,blenched
blend -> blends,blent,blended,blending
bless -> blesses,blessing,blessed,blest
blether -> blethers,blethering,blethered
blight -> blights,blighting,blighted
blind -> blinds,blinding,blinded
blindfold -> blindfolds,blindfolding,blindfolded
blink -> blinks,blinking,blinked
blister -> blisters,blistering,blistered
blitz -> blitzes,blitzing,blitzed
block -> blocks,blocking,blocked
blockade -> blockades,blockading,blockaded
bloody -> bloodies,bloodying,bloodied,bloodier,bloodiest
bloom -> blooms,blooming,bloomed
blossom -> blossoms,blossoming,blossomed
blot -> blots,blotting,blotted
blow -> blows,blew,blown,blowed,blowing
blow-dry -> blow-dries,blow-drying,blow-dried
blubber -> blubbers,blubbering,blubbered
bludgeon -> bludgeons,bludgeoning,bludgeoned
blue -> bluer,bluest,blues,blueing,blued
bluff -> bluffs,bluffing,bluffed
blunder -> blunders,blundering,blundered
blunt -> blunter,bluntest,blunts,blunting,blunted
blur -> blurs,blurring,blurred
blurt -> blurts,blurting,blurted
blush -> blushes,blushing,blushed
bluster -> blusters,blustering,blustered
board -> boards,boarding,boarded
boast -> boasts,boasting,boasted
bob -> bobs,bobbing,bobbed
bode -> bodes,boding,boded
bodge -> bodges,bodging,bodged
boggle -> boggles,boggling,boggled
boil -> boils,boiling,boiled
bolster -> bolsters,bolstering,bolstered
bolt -> bolts,bolting,bolted
bomb -> bombs,bombing,bombed
bombard -> bombards,bombarding,bombarded
bond -> bonds,bonding,bonded
bone -> bones,boning,boned
boo -> boos,booing,booed
boob -> boobs,boobing,boobed
booby-trap -> booby-traps,booby-trapping,booby-trapped
boogie -> boogies,boogieing,boogied
boohoo -> boohoos,boohooing,boohooed
book -> books,booking,booked
boom -> booms,booming,boomed
boomerang -> boomerangs,boomeranging,boomeranged
boost -> boosts,boosting,boosted
boot -> boots,booting,booted
booze -> boozes,boozing,boozed
bop -> bops,bopping,bopped
border -> borders,bordering,bordered
bore -> bores,boring,bored
borrow -> borrows,borrowing,borrowed
boss -> bosses,bossing,bossed
botch -> botches,botching,botched
bother -> bothers,bothering,bothered
bottle -> bottles,bottling,bottled
bottle-feed -> bottle-feeds,bottle-feeding,bottle-fed
bottom -> bottoms,bottoming,bottomed
bounce -> bounces,bouncing,bounced
bound -> bounds,bounding,bounded
bow -> bows,bowing,bowed
bowl -> bowls,bowling,bowled
box -> boxes,boxing,boxed
boycott -> boycotts,boycotting,boycotted
brace -> braces,bracing,braced
bracket -> brackets,bracketing,bracketed
brag -> brags,bragging,bragged
braid -> braids,braiding,braided
brain -> brains,braining,brained
brainwash -> brainwashes,brainwashing,brainwashed
braise -> braises,braising,braised
brake -> brakes,braking,braked
branch -> branches,branching,branched
brand -> brands,branding,branded
brandish -> brandishes,brandishing,brandished
brave -> braver,bravest,braves,braving,braved
brawl -> brawls,brawling,brawled
bray -> brays,braying,brayed
brazen -> brazens,brazening,brazened
breach -> breaches,breaching,breached
break -> breaks,breaking,broke,broken
breakfast -> breakfasts,breakfasting,breakfasted
breast -> breasts,breasting,breasted
breast-feed -> breast-feeds,breast-feeding,breast-fed
breathalyze -> breathalyzes,breathalyzing,breathalyzed
breathe -> breathes,breathing,breathed
breed -> breeds,breeding,bred
breeze -> breezes,breezing,breezed
brew -> brews,brewing,brewed
bribe -> bribes,bribing,bribed
brick -> bricks,bricking,bricked
bridge -> bridges,bridging,bridged
bridle -> bridles,bridling,bridled
brief -> briefer,briefest,briefs,briefing,briefed
brighten -> brightens,brightening,brightened
brim -> brims,brimming,brimmed
bring -> brings,bringing,brought
bristle -> bristles,bristling,bristled
broach -> broaches,broaching,broached
broad -> broader,broadest,broads
broadcast -> broadcasts,broadcasting,broadcasted
broaden -> broadens,broadening,broadened
broil -> broils,broiling,broiled
brood -> broods,brooding,brooded
brook -> brooks,brooking,brooked
browbeat -> browbeats,browbeating,browbeaten
brown -> browner,brownest,browns,browning,browned
browse -> browses,browsing,browsed
bruise -> bruises,bruising,bruised
brush -> brushes,brushing,brushed
brutalize -> brutalizes,brutalizing,brutalized
bubble -> bubbles,bubbling,bubbled
buck -> bucks,bucking,bucked
bucket -> buckets,bucketing,bucketed
buckle -> buckles,buckling,buckled
bud -> buds,budding,budded
budge -> budges,budging,budged
budget -> budgets,budgeting,budgeted
buff -> buffs,buffing,buffed
buffer -> buffers,buffering,buffered
buffet -> buffets,buffeting,buffeted
bug -> bugs,bugging,bugged
bugger -> buggers,buggering,buggered
build -> builds,building,built
bulge -> bulges,bulging,bulged
bulk -> bulks,bulking,bulked
bulldoze -> bulldozes,bulldozing,bulldozed
bullshit -> bullshits,bullshitting,bullshitted
bully -> bullies,bullying,bullied
bum -> bums,bumming,bummed
bumble -> bumbles,bumbling,bumbled
bump -> bumps,bumping,bumped
bunch -> bunches,bunching,bunched
bundle -> bundles,bundling,bundled
bung -> bungs,bunging,bunged
bungle -> bungles,bungling,bungled
buoy -> buoys,buoying,buoyed
burble -> burbles,burbling,burbled
burden -> burdens,burdening,burdened
burgeon -> burgeons,burgeoning,burgeoned
burglarize -> burglarizes,burglarizing,burglarized
burgle -> burgles,burgling,burgled
burn -> burns,burning,burned,burnt
burnish -> burnishes,burnishing,burnished
burp -> burps,burping,burped
burr -> burrs,burring,burred
burrow -> burrows,burrowing,burrowed
bury -> buries,burying,buried
bus -> buses,busses,bussing,bussed
busk -> busks,busking,busked
bust -> busts,busting,busted
bustle -> bustles,bustling,bustled
busy -> busier,busiest,busies,busying,busied
butcher -> butchers,butchering,butchered
butt -> butts,butting,butted
butter -> butters,buttering,buttered
button -> buttons,buttoning,buttoned
buttonhole -> buttonholes,buttonholing,buttonholed
buttress -> buttresses,buttressing,buttressed
buy -> buys,buying,bought
buzz -> buzzes,buzzing,buzzed
bypass -> bypasses,bypassing,bypassed
cable -> cables,cabling,cabled
cackle -> cackles,cackling,cackled
caddie -> caddies,caddying,caddied
cadge -> cadges,cadging,cadged
cajole -> cajoles,cajoling,cajoled
cake -> cakes,caking,caked
calculate -> calculates,calculating,calculated
calibrate -> calibrates,calibrating,calibrated
call -> calls,calling,called
calm -> calmer,calmest,calms,calming,calmed
calve -> calves,calving,calved
camouflage -> camouflages,camouflaging,camouflaged
camp -> camps,camping,camped
campaign -> campaigns,campaigning,campaigned
canalize -> canalizes,canalizing,canalized
cancel -> cancels,cancelling,cancelled
cane -> canes,caning,caned
cannibalize -> cannibalizes,cannibalizing,cannibalized
cannon -> cannons,cannoning,cannoned
canonize -> canonizes,canonizing,canonized
canoodle -> canoodles,canoodling,canoodled
canter -> canters,cantering,cantered
canvass -> canvasses,canvassing,canvassed
cap -> caps,capping,capped
caper -> capers,capering,capered
capitalize -> capitalizes,capitalizing,capitalized
capitulate -> capitulates,capitulating,capitulated
capsize -> capsizes,capsizing,capsized
captain -> captains,captaining,captained
caption -> captions,captioning,captioned
captivate -> captivates,captivating,captivated
capture -> captures,capturing,captured
care -> cares,caring,cared
career -> careers,careering,careered
caress -> caresses,caressing,caressed
caricature -> caricatures,caricaturing,caricatured
carol -> carols,carolling,carolled
carouse -> carouses,carousing,caroused
carp -> carps,carping,carped
carpet -> carpets,carpeting,carpeted
carry -> carries,carrying,carried
cart -> carts,carting,carted
cartwheel -> cartwheels,cartwheeling,cartwheeled
carve -> carves,carving,carved
cascade -> cascades,cascading,cascaded
case -> cases,casing,cased
cash -> cashes,cashing,cashed
cashier -> cashiers,cashiering,cashiered
casserole -> casseroles,casseroling,casseroled
castigate -> castigates,castigating,castigated
castrate -> castrates,castrating,castrated
catalogue -> catalogues,cataloguing,catalogued
catapult -> catapults,catapulting,catapulted
catch -> catches,catching,caught
categorize -> categorizes,categorizing,categorized
cater -> caters,catering,catered
caterwaul -> caterwauls,caterwauling,caterwauled
catnap -> catnaps,catnapping,catnapped
cause -> causes,causing,caused
cauterize -> cauterizes,cauterizing,cauterized
caution -> cautions,cautioning,cautioned
cave -> caves,caving,caved
cavil -> cavils,cavilling,cavilled
cavort -> cavorts,cavorting,cavorted
caw -> caws,cawing,cawed
cease -> ceases,ceasing,ceased
cede -> cedes,ceding,ceded
celebrate -> celebrates,celebrating,celebrated
cement -> cements,cementing,cemented
censor -> censors,censoring,censored
censure -> censures,censuring,censured
centralize -> centralizes,centralizing,centralized
centre -> centres,centring,centred
certify -> certifies,certifying,certified
chafe -> chafes,chafing,chafed
chagrin -> chagrins,chagrining,chagrined
chain -> chains,chaining,chained
chain-smoke -> chain-smokes,chain-smoking,chain-smoked
chair -> chairs,chairing,chaired
chalk -> chalks,chalking,chalked
challenge -> challenges,challenging,challenged
champ -> champs,champing,champed
champion -> champions,championing,championed
chance -> chances,chancing,chanced
change -> changes,changing,changed
channel -> channels,channelling,channelled
chant -> chants,chanting,chanted
chaperone -> chaperones,chaperoning,chaperoned
char -> chars,charring,charred
characterize -> characterizes,characterizing,characterized
charge -> charges,charging,charged
charm -> charms,charming,charmed
chart -> charts,charting,charted
charter -> charters,chartering,chartered
chase -> chases,chasing,chased
chasten -> chastens,chastening,chastened
chastise -> chastises,chastising,chastised
chat -> chats,chatting,chatted
chatter -> chatters,chattering,chattered
chauffeur -> chauffeurs,chauffeuring,chauffeured
cheapen -> cheapens,cheapening,cheapened
cheat -> cheats,cheating,cheated
check -> checks,checking,checked
checkmate -> checkmates,checkmating,checkmated
cheek -> cheeks,cheeking,cheeked
cheer -> cheers,cheering,cheered
cherish -> cherishes,cherishing,cherished
chew -> chews,chewing,chewed
chicken -> chickens,chickening,chickened
chide -> chid,chides,chidded,chided,chiding
chill -> chills,chilling,chilled
chime -> chimes,chiming,chimed
chink -> chinks,chinking,chinked
chip -> chips,chipping,chipped
chirp -> chirps,chirping,chirped
chirrup -> chirrups,chirruping,chirruped
chisel -> chisels,chiselling,chiselled
chitter -> chitters,chittering,chittered
chivvy -> chivvies,chivvying,chivvied
chlorinate -> chlorinates,chlorinating,chlorinated
chloroform -> chloroforms,chloroforming,chloroformed
choice -> choices,choicer,choicest
choke -> chokes,choking,choked
chomp -> chomps,chomping,chomped
choose -> chooses,choosing,chose,chosen
chop -> chops,chopping,chopped
choreograph -> choreographs,choreographing,choreographed
chortle -> chortles,chortling,chortled
chorus -> choruses,chorusing,chorused
christen -> christens,christening,christened
chronicle -> chronicles,chronicling,chronicled
chuck -> chucks,chucking,chucked
chuckle -> chuckles,chuckling,chuckled
chug -> chugs,chugging,chugged
chum -> chums,chumming,chummed
churn -> churns,churning,churned
circle -> circles,circling,circled
circulate -> circulates,circulating,circulated
circumcise -> circumcises,circumcising,circumcised
circumscribe -> circumscribes,circumscribing,circumscribed
circumvent -> circumvents,circumventing,circumvented
cite -> cites,citing,cited
civilize -> civilizes,civilizing,civilized
clack -> clacks,clacking,clacked
claim -> claims,claiming,claimed
clam -> clams,clamming,clammed
clamber -> clambers,clambering,clambered
clamour -> clamours,clamouring,clamoured
clamp -> clamps,clamping,clamped
clang -> clangs,clanging,clanged
clank -> clanks,clanking,clanked
clap -> claps,clapping,clapped
clarify -> clarifies,clarifying,clarified
clash -> clashes,clashing,clashed
clasp -> clasps,clasping,clasped
class -> classes,classing,classed
classify -> classifies,classifying,classified
clatter -> clatters,clattering,clattered
claw -> claws,clawing,clawed
clean -> cleaner,cleanest,cleans,cleaning,cleaned
cleanse -> cleanses,cleansing,cleansed
clear -> clearer,clearest,clears,clearing,cleared
cleave -> clove,cleft,cleaved,cloven,cleaves,cleaving
clench -> clenches,clenching,clenched
click -> clicks,clicking,clicked
climax -> climaxes,climaxing,climaxed
climb -> climbs,climbing,climbed
clinch -> clinches,clinching,clinched
cling -> clings,clinging,clung
clink -> clinks,clinking,clinked
clip -> clips,clipping,clipped
cloak -> cloaks,cloaking,cloaked
clobber -> clobbers,clobbering,clobbered
clock -> clocks,clocking,clocked
clog -> clogs,clogging,clogged
cloister -> cloisters,cloistering,cloistered
clone -> clones,cloning,cloned
clonk -> clonks,clonking,clonked
clop -> clops,clopping,clopped
close -> closes,closing,closed,closer,closest
closet -> closets,closeting,closeted
clot -> clots,clotting,clotted
clothe -> clothes,clad,clothed,clothing
cloud -> clouds,clouding,clouded
clout -> clouts,clouting,clouted
clown -> clowns,clowning,clowned
club -> clubs,clubbing,clubbed
cluck -> clucks,clucking,clucked
clump -> clumps,clumping,clumped
cluster -> clusters,clustering,clustered
clutch -> clutches,clutching,clutched
clutter -> clutters,cluttering,cluttered
co-operate -> co-operates,co-operating,co-operated
co-opt -> co-opts,co-opting,co-opted
co-ordinate -> co-ordinates,co-ordinating,co-ordinated
co-star -> co-stars,co-starring,co-starred
coach -> coaches,coaching,coached
coagulate -> coagulates,coagulating,coagulated
coalesce -> coalesces,coalescing,coalesced
coarsen -> coarsens,coarsening,coarsened
coast -> coasts,coasting,coasted
coat -> coats,coating,coated
coax -> coaxes,coaxing,coaxed
cobble -> cobbles,cobbling,cobbled
cock -> cocks,cocking,cocked
cocoon -> cocoons,cocooning,cocooned
coddle -> coddles,coddling,coddled
code -> codes,coding,coded
codify -> codifies,codifying,codified
coerce -> coerces,coercing,coerced
coexist -> coexists,coexisting,coexisted
cogitate -> cogitates,cogitating,cogitated
cohabit -> cohabits,cohabiting,cohabited
cohere -> coheres,cohering,cohered
coil -> coils,coiling,coiled
coin -> coins,coining,coined
coincide -> coincides,coinciding,coincided
cold -> colder,coldest,colds
cold-shoulder -> cold-shoulders,cold-shouldering,cold-shouldered
collaborate -> collaborates,collaborating,collaborated
collapse -> collapses,collapsing,collapsed
collar -> collars,collaring,collared
collate -> collates,collating,collated
collect -> collects,collecting,collected
collectivize -> collectivizes,collectivizing,collectivized
collide -> collides,colliding,collided
collocate -> collocates,collocating,collocated
collude -> colludes,colluding,colluded
colonize -> colonizes,colonizing,colonized
colorcast -> colorcasts,colorcasted,colorcasting
colour -> colours,colouring,coloured
comb -> combs,combing,combed
combat -> combats,combating,combated
combine -> combines,combining,combined
come -> comes,coming,came
comfort -> comforts,comforting,comforted
command -> commands,commanding,commanded
commandeer -> commandeers,commandeering,commandeered
commemorate -> commemorates,commemorating,commemorated
commence -> commences,commencing,commenced
commend -> commends,commending,commended
comment -> comments,commenting,commented
commentate -> commentates,commentating,commentated
commiserate -> commiserates,commiserating,commiserated
commission -> commissions,commissioning,commissioned
commit -> commits,committing,committed
common -> commoner,commonest,commons
commune -> communes,communing,communed
communicate -> communicates,communicating,communicated
commute -> commutes,commuting,commuted
compact -> compacts,compacting,compacted
compare -> compares,comparing,compared
compartmentalize -> compartmentalizes,compartmentalizing,compartmentalized
compel -> compels,compelling,compelled
compensate -> compensates,compensating,compensated
compere -> comperes,compering,compered
compete -> competes,competing,competed
compile -> compiles,compiling,compiled
complain -> complains,complaining,complained
complement -> complements,complementing,complemented
complete -> completes,completing,completed
complicate -> complicates,complicating,complicated
compliment -> compliments,complimenting,complimented
comply -> complies,complying,complied
comport -> comports,comporting,comported
compose -> composes,composing,composed
compost -> composts,composting,composted
compound -> compounds,compounding,compounded
comprehend -> comprehends,comprehending,comprehended
compress -> compresses,compressing,compressed
comprise -> comprises,comprising,comprised
compromise -> compromises,compromising,compromised
compute -> computes,computing,computed
computerize -> computerizes,computerizing,computerized
con -> cons,conning,conned
conceal -> conceals,concealing,concealed
concede -> concedes,conceding,conceded
conceive -> conceives,conceiving,conceived
concentrate -> concentrates,concentrating,concentrated
conceptualize -> conceptualizes,conceptualizing,conceptualized
concern -> concerns,concerning,concerned
concertina -> concertinas,concertinaing,concertinaed
conciliate -> conciliates,conciliating,conciliated
conclude -> concludes,concluding,concluded
concoct -> concocts,concocting,concocted
concrete -> concretes,concreting,concreted
concur -> concurs,concurring,concurred
concuss -> concusses,concussing,concussed
condemn -> condemns,condemning,condemned
condense -> condenses,condensing,condensed
condescend -> condescends,condescending,condescended
condition -> conditions,conditioning,conditioned
condole -> condoles,condoling,condoled
condone -> condones,condoning,condoned
conduct -> conducts,conducting,conducted
cone -> cones,coning,coned
confer -> confers,conferring,conferred
confess -> confesses,confessing,confessed
confide -> confides,confiding,confided
confine -> confines,confining,confined
confirm -> confirms,confirming,confirmed
confiscate -> confiscates,confiscating,confiscated
conflate -> conflates,conflating,conflated
conflict -> conflicts,conflicting,conflicted
conform -> conforms,conforming,conformed
confound -> confounds,confounding,confounded
confront -> confronts,confronting,confronted
confuse -> confuses,confusing,confused
congeal -> congeals,congealing,congealed
congratulate -> congratulates,congratulating,congratulated
congregate -> congregates,congregating,congregated
conjecture -> conjectures,conjecturing,conjectured
conjure -> conjures,conjuring,conjured
conk -> conks,conking,conked
connect -> connects,connecting,connected
connive -> connives,conniving,connived
connote -> connotes,connoting,connoted
conquer -> conquers,conquering,conquered
conscript -> conscripts,conscripting,conscripted
consecrate -> consecrates,consecrating,consecrated
consent -> consents,consenting,consented
conserve -> conserves,conserving,conserved
consider -> considers,considering,considered
consign -> consigns,consigning,consigned
consist -> consists,consisting,consisted
console -> consoles,consoling,consoled
consolidate -> consolidates,consolidating,consolidated
consort -> consorts,consorting,consorted
conspire -> conspires,conspiring,conspired
constitute -> constitutes,constituting,constituted
constrain -> constrains,constraining,constrained
constrict -> constricts,constricting,constricted
construct -> constructs,constructing,constructed
construe -> construes,construing,construed
consult -> consults,consulting,consulted
consume -> consumes,consuming,consumed
consummate -> consummates,consummating,consummated
contact -> contacts,contacting,contacted
contain -> contains,containing,contained
contaminate -> contaminates,contaminating,contaminated
contemplate -> contemplates,contemplating,contemplated
contend -> contends,contending,contended
content -> contents,contenting,contented
contest -> contests,contesting,contested
continue -> continues,continuing,continued
contort -> contorts,contorting,contorted
contract -> contracts,contracting,contracted
contradict -> contradicts,contradicting,contradicted
contrast -> contrasts,contrasting,contrasted
contravene -> contravenes,contravening,contravened
contribute -> contributes,contributing,contributed
contrive -> contrives,contriving,contrived
control -> controls,controlling,controlled
convalesce -> convalesces,convalescing,convalesced
convene -> convenes,convening,convened
convenience -> conveniences,convenienced,conveniencing
converge -> converges,converging,converged
converse -> converses,conversing,conversed
convert -> converts,converting,converted
convey -> conveys,conveying,conveyed
convict -> convicts,convicting,convicted
convince -> convinces,convincing,convinced
convulse -> convulses,convulsing,convulsed
coo -> coos,cooing,cooed
cook -> cooks,cooking,cooked
cool -> cooler,coolest,cools,cooling,cooled
coop -> coops,cooping,cooped
cop -> cops,copping,copped
cope -> copes,coping,coped
copulate -> copulates,copulating,copulated
copy -> copies,copying,copied
cordon -> cordons,cordoning,cordoned
core -> cores,coring,cored
cork -> corks,corking,corked
corner -> corners,cornering,cornered
corral -> corrals,corralling,corralled
correct -> corrects,correcting,corrected
correlate -> correlates,correlating,correlated
correspond -> corresponds,corresponding,corresponded
corroborate -> corroborates,corroborating,corroborated
corrode -> corrodes,corroding,corroded
corrupt -> corrupts,corrupting,corrupted
cosh -> coshes,coshing,coshed
cosset -> cossets,cosseting,cosseted
cost -> costs,costing,costed
cosy -> cosier,cosiest,cosies
cotton -> cottons,cottoning,cottoned
couch -> couches,couching,couched
cough -> coughs,coughing,coughed
counsel -> counsels,counselling,counselled
count -> counts,counting,counted
countenance -> countenances,countenancing,countenanced
counter -> counters,countering,countered
counter-attack -> counter-attacks,counter-attacking,counter-attacked
counteract -> counteracts,counteracting,counteracted
counterbalance -> counterbalances,counterbalancing,counterbalanced
counterfeit -> counterfeits,counterfeiting,counterfeited
countermand -> countermands,countermanding,countermanded
countersign -> countersigns,countersigning,countersigned
countersink -> countersinks,countersank,countersunk,countersinking
couple -> couples,coupling,coupled
course -> courses,coursing,coursed
court -> courts,courting,courted
court-martial -> court-martials,court-martialling,court-martialled
cover -> covers,covering,covered
covet -> covets,coveting,coveted
cow -> cows,cowing,cowed
cower -> cowers,cowering,cowered
crack -> cracks,cracking,cracked
crackle -> crackles,crackling,crackled
cradle -> cradles,cradling,cradled
craft -> crafts,crafting,crafted
cram -> crams,cramming,crammed
cramp -> cramps,cramping,cramped
crane -> cranes,craning,craned
crank -> cranks,cranking,cranked
crap -> craps,crapping,crapped
crash -> crashes,crashing,crashed
crate -> crates,crating,crated
crave -> craves,craving,craved
crawl -> crawls,crawling,crawled
crayon -> crayons,crayoning,crayoned
crazy -> crazier,craziest,crazies
creak -> creaks,creaking,creaked
cream -> creams,creaming,creamed
crease -> creases,creasing,creased
create -> creates,creating,created
credit -> credits,crediting,credited
creep -> creeps,creeping,crept
cremate -> cremates,cremating,cremated
creosote -> creosotes,creosoting,creosoted
crib -> cribs,cribbing,cribbed
crick -> cricks,cricking,cricked
crimp -> crimps,crimping,crimped
cringe -> cringes,cringing,cringed
crinkle -> crinkles,crinkling,crinkled
cripple -> cripples,crippling,crippled
crisp -> crisper,crispest,crisps
criss-cross -> criss-crosses,criss-crossing,criss-crossed
criticize -> criticizes,criticizing,criticized
croak -> croaks,croaking,croaked
crochet -> crochets,crocheting,crocheted
crook -> crooks,crooking,crooked
croon -> croons,crooning,crooned
crop -> crops,cropping,cropped
cross -> crosses,crossing,crossed,crosser,crossest
cross-check -> cross-checks,cross-checking,cross-checked
cross-examine -> cross-examines,cross-examining,cross-examined
cross-question -> cross-questions,cross-questioning,cross-questioned
cross-reference -> cross-references,cross-referencing,cross-referenced
crossbreed -> crossbreeds,crossbred,crossbreeding
crouch -> crouches,crouching,crouched
crow -> crows,crew,crowed,crowing
crowd -> crowds,crowding,crowded
crown -> crowns,crowning,crowned
crucify -> crucifies,crucifying,crucified
cruise -> cruises,cruising,cruised
crumble -> crumbles,crumbling,crumbled
crumple -> crumples,crumpling,crumpled
crunch -> crunches,crunching,crunched
crusade -> crusades,crusading,crusaded
crush -> crushes,crushing,crushed
cry -> cries,crying,cried
crystallize -> crystallizes,crystallizing,crystallized
cube -> cubes,cubing,cubed
cuckold -> cuckolds,cuckolding,cuckolded
cuddle -> cuddles,cuddling,cuddled
cudgel -> cudgels,cudgelling,cudgelled
cue -> cues,cueing,cued
cuff -> cuffs,cuffing,cuffed
cull -> culls,culling,culled
culminate -> culminates,culminating,culminated
cultivate -> cultivates,cultivating,cultivated
culture -> cultures,culturing,cultured
cup -> cups,cupping,cupped
curb -> curbs,curbing,curbed
curdle -> curdles,curdling,curdled
cure -> cures,curing,cured
curl -> curls,curling,curled
curry -> curries,currying,curried
curse -> curses,curst,cursed,cursing
curtail -> curtails,curtailing,curtailed
curtain -> curtains,curtaining,curtained
curtsy -> curtsies,curtsying,curtsied
curve -> curves,curving,curved
cushion -> cushions,cushioning,cushioned
cuss -> cusses,cussing,cussed
customize -> customizes,customizing,customized
cycle -> cycles,cycling,cycled
dab -> dabs,dabbing,dabbed
dabble -> dabbles,dabbling,dabbled
dally -> dallies,dallying,dallied
dam -> dams,damming,dammed
damage -> damages,damaging,damaged
damp -> damper,dampest,damps,damping,damped
dampen -> dampens,dampening,dampened
dance -> dances,dancing,danced
dandy -> dandies,dandier,dandiest
dangle -> dangles,dangling,dangled
dare -> dares,daring,dared
darken -> darkens,darkening,darkened
darn -> darns,darning,darned
dart -> darts,darting,darted
dash -> dashes,dashing,dashed
date -> dates,dating,dated
daub -> daubs,daubing,daubed
daunt -> daunts,daunting,daunted
dawdle -> dawdles,dawdling,dawdled
dawn -> dawns,dawning,dawned
daydream -> daydreams,daydreaming,daydreamed
dazzle -> dazzles,dazzling,dazzled
de-escalate -> de-escalates,de-escalating,de-escalated
deactivate -> deactivates,deactivating,deactivated
deaden -> deadens,deadening,deadened
deafen -> deafens,deafening,deafened
deal -> deals,dealing,dealt
dear -> dearer,dearest,dears
debar -> debars,debarring,debarred
debase -> debases,debasing,debased
debate -> debates,debating,debated
debauch -> debauches,debauching,debauched
debilitate -> debilitates,debilitating,debilitated
debit -> debits,debiting,debited
debrief -> debriefs,debriefing,debriefed
debug -> debugs,debugging,debugged
debunk -> debunks,debunking,debunked
decamp -> decamps,decamping,decamped
decant -> decants,decanting,decanted
decapitate -> decapitates,decapitating,decapitated
decay -> decays,decaying,decayed
deceive -> deceives,deceiving,deceived
decelerate -> decelerates,decelerating,decelerated
decentralize -> decentralizes,decentralizing,decentralized
decide -> decides,deciding,decided
decimalize -> decimalizes,decimalizing,decimalized
decimate -> decimates,decimating,decimated
decipher -> deciphers,deciphering,deciphered
deck -> decks,decking,decked
declaim -> declaims,declaiming,declaimed
declare -> declares,declaring,declared
declassify -> declassifies,declassifying,declassified
decline -> declines,declining,declined
decode -> decodes,decoding,decoded
decolonize -> decolonizes,decolonizing,decolonized
decompose -> decomposes,decomposing,decomposed
decontaminate -> decontaminates,decontaminating,decontaminated
decorate -> decorates,decorating,decorated
decoy -> decoys,decoying,decoyed
decrease -> decreases,decreasing,decreased
decree -> decrees,decreeing,decreed
decry -> decries,decrying,decried
dedicate -> dedicates,dedicating,dedicated
deduce -> deduces,deducing,deduced
deduct -> deducts,deducting,deducted
deem -> deems,deeming,deemed
deep -> deeper,deepest,deeps
deep-freeze -> deep-freezes,deep-freezed,deep-froze,deep-frozen,deep-freezing
deep-fry -> deep-fries,deep-frying,deep-fried
deepen -> deepens,deepening,deepened
deface -> defaces,defacing,defaced
defame -> defames,defaming,defamed
default -> defaults,defaulting,defaulted
defeat -> defeats,defeating,defeated
defecate -> defecates,defecating,defecated
defect -> defects,defecting,defected
defend -> defends,defending,defended
defer -> defers,deferring,deferred
defile -> defiles,defiling,defiled
define -> defines,defining,defined
deflate -> deflates,deflating,deflated
deflect -> deflects,deflecting,deflected
deflower -> deflowers,deflowering,deflowered
defoliate -> defoliates,defoliating,defoliated
deforest -> deforests,deforesting,deforested
deform -> deforms,deforming,deformed
defraud -> defrauds,defrauding,defrauded
defray -> defrays,defraying,defrayed
defrost -> defrosts,defrosting,defrosted
defuse -> defuses,defusing,defused
defy -> defies,defying,defied
degenerate -> degenerates,degenerating,degenerated
degrade -> degrades,degrading,degraded
dehumanize -> dehumanizes,dehumanizing,dehumanized
dehydrate -> dehydrates,dehydrating,dehydrated
deify -> deifies,deifying,deified
deign -> deigns,deigning,deigned
delay -> delays,delaying,delayed
delegate -> delegates,delegating,delegated
delete -> deletes,deleting,deleted
deliberate -> deliberates,deliberating,deliberated
delight -> delights,delighting,delighted
delimit -> delimits,delimiting,delimited
delineate -> delineates,delineating,delineated
deliver -> delivers,delivering,delivered
delouse -> delouses,delousing,deloused
delude -> deludes,deluding,deluded
deluge -> deluges,deluging,deluged
delve -> delves,delving,delved
demand -> demands,demanding,demanded
demarcate -> demarcates,demarcating,demarcated
demean -> demeans,demeaning,demeaned
demilitarize -> demilitarizes,demilitarizing,demilitarized
demist -> demists,demisting,demisted
demob -> demobs,demobbing,demobbed
demobilize -> demobilizes,demobilizing,demobilized
democratize -> democratizes,democratizing,democratized
demolish -> demolishes,demolishing,demolished
demonstrate -> demonstrates,demonstrating,demonstrated
demoralize -> demoralizes,demoralizing,demoralized
demote -> demotes,demoting,demoted
demur -> demurs,demurring,demurred
demystify -> demystifies,demystifying,demystified
denationalize -> denationalizes,denationalizing,denationalized
denigrate -> denigrates,denigrating,denigrated
denote -> denotes,denoting,denoted
denounce -> denounces,denouncing,denounced
dent -> dents,denting,dented
denude -> denudes,denuding,denuded
deny -> denies,denying,denied
deodorize -> deodorizes,deodorizing,deodorized
depart -> departs,departing,departed
depend -> depends,depending,depended
depict -> depicts,depicting,depicted
deplete -> depletes,depleting,depleted
deplore -> deplores,deploring,deplored
deploy -> deploys,deploying,deployed
depopulate -> depopulates,depopulating,depopulated
deport -> deports,deporting,deported
depose -> deposes,deposing,deposed
deposit -> deposits,depositing,deposited
deprave -> depraves,depraving,depraved
deprecate -> deprecates,deprecating,deprecated
deprecate -> deprecates,deprecating,deprecated
depreciate -> depreciates,depreciating,depreciated
depreciate -> depreciates,depreciating,depreciated
depress -> depresses,depressing,depressed
depress -> depresses,depressing,depressed
deprive -> deprives,depriving,deprived
deride -> derides,deriding,derided
derive -> derives,deriving,derived
descale -> descales,descaling,descaled
descend -> descends,descending,descended
describe -> describes,describing,described
desecrate -> desecrates,desecrating,desecrated
desegregate -> desegregates,desegregating,desegregated
desensitize -> desensitizes,desensitizing,desensitized
desert -> deserts,deserting,deserted
deserve -> deserves,deserving,deserved
design -> designs,designing,designed
designate -> designates,designating,designated
desire -> desires,desiring,desired
desist -> desists,desisting,desisted
desolate -> desolates,desolating,desolated
despair -> despairs,despairing,despaired
despise -> despises,despising,despised
despoil -> despoils,despoiling,despoiled
destroy -> destroys,destroying,destroyed
detach -> detaches,detaching,detached
detail -> details,detailing,detailed
detain -> detains,detaining,detained
detect -> detects,detecting,detected
deter -> deters,deterring,deterred
deteriorate -> deteriorates,deteriorating,deteriorated
determine -> determines,determining,determined
detest -> detests,detesting,detested
dethrone -> dethrones,dethroning,dethroned
detonate -> detonates,detonating,detonated
detract -> detracts,detracting,detracted
devalue -> devalues,devaluing,devalued
devastate -> devastates,devastating,devastated
develop -> develops,developing,developed
deviate -> deviates,deviating,deviated
devise -> devises,devising,devised
devolve -> devolves,devolving,devolved
devote -> devotes,devoting,devoted
devour -> devours,devouring,devoured
diagnose -> diagnoses,diagnosing,diagnosed
dial -> dials,dialling,dialled
dice -> dices,dicing,diced
dicky -> dickies,dickier,dickiest
dictate -> dictates,dictating,dictated
diddle -> diddles,diddling,diddled
die -> dies,dying,died
diet -> diets,dieting,dieted
differ -> differs,differing,differed
differentiate -> differentiates,differentiating,differentiated
diffuse -> diffuses,diffusing,diffused
dig -> digs,digging,dug
digest -> digests,digesting,digested
dignify -> dignifies,dignifying,dignified
digress -> digresses,digressing,digressed
dilate -> dilates,dilating,dilated
dilute -> dilutes,diluting,diluted
dim -> dimmer,dimmest,dims,dimming,dimmed
diminish -> diminishes,diminishing,diminished
din -> dins,dinning,dinned
dine -> dines,dining,dined
dip -> dips,dipping,dipped
direct -> directs,directing,directed
dirty -> dirtier,dirtiest,dirties,dirtying,dirtied
disable -> disables,disabling,disabled
disabuse -> disabuses,disabusing,disabused
disagree -> disagrees,disagreeing,disagreed
disallow -> disallows,disallowing,disallowed
disappear -> disappears,disappearing,disappeared
disappoint -> disappoints,disappointing,disappointed
disapprove -> disapproves,disapproving,disapproved
disarm -> disarms,disarming,disarmed
disarrange -> disarranges,disarranging,disarranged
disassociate -> disassociates,disassociating,disassociated
disavow -> disavows,disavowing,disavowed
disband -> disbands,disbanding,disbanded
disbelieve -> disbelieves,disbelieving,disbelieved
disburse -> disburses,disbursing,disbursed
discard -> discards,discarding,discarded
discern -> discerns,discerning,discerned
discharge -> discharges,discharging,discharged
discipline -> disciplines,disciplining,disciplined
disclaim -> disclaims,disclaiming,disclaimed
disclose -> discloses,disclosing,disclosed
discolour -> discolours,discolouring,discoloured
discomfit -> discomfits,discomfiting,discomfited
disconcert -> disconcerts,disconcerting,disconcerted
disconnect -> disconnects,disconnecting,disconnected
discontinue -> discontinues,discontinuing,discontinued
discount -> discounts,discounting,discounted
discourage -> discourages,discouraging,discouraged
discourse -> discourses,discoursing,discoursed
discover -> discovers,discovering,discovered
discredit -> discredits,discrediting,discredited
discriminate -> discriminates,discriminating,discriminated
discuss -> discusses,discussing,discussed
disdain -> disdains,disdaining,disdained
disembark -> disembarks,disembarking,disembarked
disembowel -> disembowels,disembowelling,disembowelled
disenfranchise -> disenfranchises,disenfranchising,disenfranchised
disengage -> disengages,disengaging,disengaged
disentangle -> disentangles,disentangling,disentangled
disestablish -> disestablishes,disestablishing,disestablished
disfigure -> disfigures,disfiguring,disfigured
disgorge -> disgorges,disgorging,disgorged
disgrace -> disgraces,disgracing,disgraced
disguise -> disguises,disguising,disguised
disgust -> disgusts,disgusting,disgusted
dish -> dishes,dishing,dished
dishonour -> dishonours,dishonouring,dishonoured
disillusion -> disillusions,disillusioning,disillusioned
disinfect -> disinfects,disinfecting,disinfected
disinherit -> disinherits,disinheriting,disinherited
disintegrate -> disintegrates,disintegrating,disintegrated
disinter -> disinters,disinterring,disinterred
dislike -> dislikes,disliking,disliked
dislocate -> dislocates,dislocating,dislocated
dislodge -> dislodges,dislodging,dislodged
dismantle -> dismantles,dismantling,dismantled
dismay -> dismays,dismaying,dismayed
dismember -> dismembers,dismembering,dismembered
dismiss -> dismisses,dismissing,dismissed
dismount -> dismounts,dismounting,dismounted
disobey -> disobeys,disobeying,disobeyed
disorganize -> disorganizes,disorganizing,disorganized
disorient -> disorients,disorienting,disoriented
disorientate -> disorientates,disorientating,disorientated
disown -> disowns,disowning,disowned
disparage -> disparages,disparaging,disparaged
dispatch -> dispatches,dispatching,dispatched
dispel -> dispels,dispelling,dispelled
dispense -> dispenses,dispensing,dispensed
disperse -> disperses,dispersing,dispersed
displace -> displaces,displacing,displaced
display -> displays,displaying,displayed
displease -> displeases,displeasing,displeased
disport -> disports,disporting,disported
dispose -> disposes,disposing,disposed
dispossess -> dispossesses,dispossessing,dispossessed
disprove -> disproves,disproving,disproved
dispute -> disputes,disputing,disputed
disqualify -> disqualifies,disqualifying,disqualified
disquiet -> disquiets,disquieting,disquieted
disregard -> disregards,disregarding,disregarded
disrobe -> disrobes,disrobing,disrobed
disrupt -> disrupts,disrupting,disrupted
dissect -> dissects,dissecting,dissected
dissemble -> dissembles,dissembling,dissembled
disseminate -> disseminates,disseminating,disseminated
dissent -> dissents,dissenting,dissented
dissimulate -> dissimulates,dissimulating,dissimulated
dissipate -> dissipates,dissipating,dissipated
dissociate -> dissociates,dissociating,dissociated
dissolve -> dissolves,dissolving,dissolved
dissuade -> dissuades,dissuading,dissuaded
distance -> distances,distancing,distanced
distend -> distends,distending,distended
distil -> distils,distilling,distilled
distinguish -> distinguishes,distinguishing,distinguished
distort -> distorts,distorting,distorted
distract -> distracts,distracting,distracted
distress -> distresses,distressing,distressed
distribute -> distributes,distributing,distributed
distrust -> distrusts,distrusting,distrusted
disturb -> disturbs,disturbing,disturbed
disunite -> disunites,disuniting,disunited
ditch -> ditches,ditching,ditched
dither -> dithers,dithering,dithered
dive -> dived,dove,dives,diving
diverge -> diverges,diverging,diverged
diversify -> diversifies,diversifying,diversified
divert -> diverts,diverting,diverted
divest -> divests,divesting,divested
divide -> divides,dividing,divided
divine -> divines,divining,divined
divorce -> divorces,divorcing,divorced
divulge -> divulges,divulging,divulged
dizzy -> dizzier,dizziest,dizzies,dizzying,dizzied
do -> does,doing,did,done
dock -> docks,docking,docked
docket -> dockets,docketing,docketed
doctor -> doctors,doctoring,doctored
document -> documents,documenting,documented
dodder -> dodders,doddering,doddered
dodge -> dodges,dodging,dodged
doff -> doffs,doffing,doffed
dog -> dogs,dogging,dogged
dogmatize -> dogmatizes,dogmatizing,dogmatized
dole -> doles,doling,doled
doll -> dolls,dolling,dolled
domesticate -> domesticates,domesticating,domesticated
dominate -> dominates,dominating,dominated
don -> dons,donning,donned
donate -> donates,donating,donated
doodle -> doodles,doodling,doodled
doom -> dooms,dooming,doomed
dope -> dopes,doping,doped
dose -> doses,dosing,dosed
dot -> dots,dotting,dotted
dote -> dotes,doting,doted
double -> doubles,doubling,doubled
double-check -> double-checks,double-checking,double-checked
double-cross -> double-crosses,double-crossing,double-crossed
double-glaze -> double-glazes,double-glazing,double-glazed
double-park -> double-parks,double-parking,double-parked
doubt -> doubts,doubting,doubted
douse -> douses,dousing,doused
dovetail -> dovetails,dovetailing,dovetailed
down -> downs,downing,downed
downgrade -> downgrades,downgrading,downgraded
dowse -> dowses,dowsing,dowsed
doze -> dozes,dozing,dozed
draft -> drafts,drafting,drafted
drag -> drags,dragging,dragged
dragoon -> dragoons,dragooning,dragooned
drain -> drains,draining,drained
dramatize -> dramatizes,dramatizing,dramatized
drape -> drapes,draping,draped
draw -> draws,drew,drawn,drawing
drawl -> drawls,drawling,drawled
dread -> dreads,dreading,dreaded
dream -> dreams,dreaming,dreamed,dreamt
dredge -> dredges,dredging,dredged
drench -> drenches,drenching,drenched
dress -> dresses,dressing,dressed
dribble -> dribbles,dribbling,dribbled
drift -> drifts,drifting,drifted
drill -> drills,drilling,drilled
drink -> drinks,drinking,drank,drunk
drip -> dripped,dript,drips,dripping
drive -> drives,driving,drove,driven
drivel -> drivels,drivelling,drivelled
drizzle -> drizzles,drizzling,drizzled
drone -> drones,droning,droned
drool -> drools,drooling,drooled
droop -> droops,drooping,drooped
drop -> drops,dropping,dropped
drown -> drowns,drowning,drowned
drowse -> drowses,drowsing,drowsed
drug -> drugs,drugging,drugged
drum -> drums,drumming,drummed
dry -> drier,dryer,driest,dries,drying
dry-clean -> dry-cleans,dry-cleaning,dry-cleaned
dub -> dubs,dubbing,dubbed
duck -> ducks,ducking,ducked
duel -> duels,duelling,duelled
duff -> duffs,duffing,duffed
dull -> duller,dullest,dulls,dulling,dulled
dump -> dumps,dumping,dumped
dunk -> dunks,dunking,dunked
dupe -> dupes,duping,duped
duplicate -> duplicates,duplicating,duplicated
dust -> dusts,dusting,dusted
dwarf -> dwarfs,dwarfing,dwarfed
dwell -> dwells,dwelling,dwelled,dwelt
dwindle -> dwindles,dwindling,dwindled
dye -> dyes,dyeing,dyed
dynamite -> dynamites,dynamiting,dynamited
earmark -> earmarks,earmarking,earmarked
earn -> earns,earning,earned
earth -> earths,earthing,earthed
ease -> eases,easing,eased
eat -> eats,ate,eaten,eating
eavesdrop -> eavesdrops,eavesdropping,eavesdropped
ebb -> ebbs,ebbing,ebbed
echo -> echoes,echoing,echoed
eclipse -> eclipses,eclipsing,eclipsed
economize -> economizes,economizing,economized
eddy -> eddies,eddying,eddied
edge -> edges,edging,edged
edify -> edifies,edifying,edified
edit -> edits,editing,edited
editorialize -> editorializes,editorializing,editorialized
educate -> educates,educating,educated
efface -> effaces,effacing,effaced
effect -> effects,effecting,effected
egg -> eggs,egging,egged
ejaculate -> ejaculates,ejaculating,ejaculated
eject -> ejects,ejecting,ejected
eke -> ekes,eking,eked
elaborate -> elaborates,elaborating,elaborated
elapse -> elapses,elapsing,elapsed
elbow -> elbows,elbowing,elbowed
elect -> elects,electing,elected
electrify -> electrifies,electrifying,electrified
electrocute -> electrocutes,electrocuting,electrocuted
electroplate -> electroplates,electroplating,electroplated
elevate -> elevates,elevating,elevated
elicit -> elicits,eliciting,elicited
elide -> elides,eliding,elided
eliminate -> eliminates,eliminating,eliminated
elongate -> elongates,elongating,elongated
elope -> elopes,eloping,eloped
elucidate -> elucidates,elucidating,elucidated
elude -> eludes,eluding,eluded
emanate -> emanates,emanating,emanated
emancipate -> emancipates,emancipating,emancipated
emasculate -> emasculates,emasculating,emasculated
embalm -> embalms,embalming,embalmed
embargo -> embargoes,embargoing,embargoed
embark -> embarks,embarking,embarked
embarrass -> embarrasses,embarrassing,embarrassed
embed -> embeds,embedding,embedded
embellish -> embellishes,embellishing,embellished
embezzle -> embezzles,embezzling,embezzled
embitter -> embitters,embittering,embittered
emblazon -> emblazons,emblazoning,emblazoned
embody -> embodies,embodying,embodied
embolden -> emboldens,emboldening,emboldened
embrace -> embraces,embracing,embraced
embroider -> embroiders,embroidering,embroidered
embroil -> embroils,embroiling,embroiled
emend -> emends,emending,emended
emerge -> emerges,emerging,emerged
emigrate -> emigrates,emigrating,emigrated
emit -> emits,emitting,emitted
empathize -> empathizes,empathizing,empathized
emphasize -> emphasizes,emphasizing,emphasized
employ -> employs,employing,employed
empower -> empowers,empowering,empowered
empty -> emptier,emptiest,empties,emptying,emptied
emulate -> emulates,emulating,emulated
emulsify -> emulsifies,emulsifying,emulsified
emulsion -> emulsions,emulsioning,emulsioned
enable -> enables,enabling,enabled
enact -> enacts,enacting,enacted
enamel -> enamels,enamelling,enamelled
encamp -> encamps,encamping,encamped
encapsulate -> encapsulates,encapsulating,encapsulated
encase -> encases,encasing,encased
enchant -> enchants,enchanting,enchanted
encircle -> encircles,encircling,encircled
enclose -> encloses,enclosing,enclosed
encode -> encodes,encoding,encoded
encompass -> encompasses,encompassing,encompass
encore -> encores,encoring,encored
encounter -> encounters,encountering,encountered
encourage -> encourages,encouraging,encouraged
encroach -> encroaches,encroaching,encroached
encumber -> encumbers,encumbering,encumbered
end -> ends,ending,ended
endanger -> endangers,endangering,endangered
endear -> endears,endearing,endeared
endeavour -> endeavours,endeavouring,endeavoured
endorse -> endorses,endorsing,endorsed
endow -> endows,endowing,endowed
endure -> endures,enduring,endured
energize -> energizes,energizing,energized
enfold -> enfolds,enfolding,enfolded
enforce -> enforces,enforcing,enforced
enfranchise -> enfranchises,enfranchising,enfranchised
engage -> engages,engaging,engaged
engender -> engenders,engendering,engendered
engineer -> engineers,engineering,engineered
engrave -> engraves,engraving,engraved
engulf -> engulfs,engulfing,engulfed
enhance -> enhances,enhancing,enhanced
enjoin -> enjoins,enjoining,enjoined
enjoy -> enjoys,enjoying,enjoyed
enlarge -> enlarges,enlarging,enlarged
enlighten -> enlightens,enlightening,enlightened
enlist -> enlists,enlisting,enlisted
enliven -> enlivens,enlivening,enlivened
ennoble -> ennobles,ennobling,ennobled
enquire -> enquires,enquiring,enquired
enrage -> enrages,enraging,enraged
enrich -> enriches,enriching,enriched
enrol -> enrols,enrolling,enrolled
ensconce -> ensconces,ensconcing,ensconced
enshrine -> enshrines,enshrining,enshrined
enshroud -> enshrouds,enshrouding,enshrouded
enslave -> enslaves,enslaving,enslaved
ensnare -> ensnares,ensnaring,ensnared
ensue -> ensues,ensuing,ensued
ensure -> ensures,ensuring,ensured
entail -> entails,entailing,entailed
entangle -> entangles,entangling,entangled
enter -> enters,entering,entered
entertain -> entertains,entertaining,entertained
enthral -> enthrals,enthralling,enthralled
enthrone -> enthrones,enthroning,enthroned
enthuse -> enthuses,enthusing,enthused
entice -> entices,enticing,enticed
entitle -> entitles,entitling,entitled
entomb -> entombs,entombing,entombed
entrance -> entrances,entrancing,entranced
entrap -> entraps,entrapping,entrapped
entreat -> entreats,entreating,entreated
entrench -> entrenches,entrenching,entrenched
entrust -> entrusts,entrusting,entrusted
entwine -> entwines,entwining,entwined
enumerate -> enumerates,enumerating,enumerated
enunciate -> enunciates,enunciating,enunciated
envelop -> envelops,enveloping,enveloped
envisage -> envisages,envisaging,envisaged
envision -> envisions,envisioning,envisioned
envy -> envies,envying,envied
epitomize -> epitomizes,epitomizing,epitomized
equal -> equals,equalling,equalled
equalize -> equalizes,equalizing,equalized
equate -> equates,equating,equated
equip -> equips,equipping,equipped
equivocate -> equivocates,equivocating,equivocate
eradicate -> eradicates,eradicating,eradicated
erase -> erases,erasing,erased
erect -> erects,erecting,erected
erode -> erodes,eroding,eroded
err -> errs,erring,erred
erupt -> erupts,erupting,erupted
escalate -> escalates,escalating,escalated
escape -> escapes,escaping,escaped
eschew -> eschews,eschewing,eschewed
escort -> escorts,escorting,escorted
espouse -> espouses,espousing,espoused
espy -> espies,espying,espied
essay -> essays,essaying,essayed
establish -> establishes,establishing,established
esteem -> esteems,esteeming,esteemed
estimate -> estimates,estimating,estimated
etch -> etchs,etching,etched
eulogize -> eulogizes,eulogizing,eulogized
evacuate -> evacuates,evacuating,evacuated
evade -> evades,evading,evaded
evaluate -> evaluates,evaluating,evaluated
evanesce -> evanesces,evanescing,evanesced
evangelize -> evangelizes,evangelizing,evangelized
evaporate -> evaporates,evaporating,evaporated
even -> evens,evening,evened
evict -> evicts,evicting,evicted
evidence -> evidences,evidencing,evidenced
evince -> evinces,evincing,evinced
evoke -> evokes,evoking,evoked
evolve -> evolves,evolving,evolved
exacerbate -> exacerbates,exacerbating,exacerbated
exact -> exacts,exacting,exacted
exaggerate -> exaggerates,exaggerating,exaggerated
exalt -> exalts,exalting,exalted
examine -> examines,examining,examined
exasperate -> exasperates,exasperating,exasperated
excavate -> excavates,excavating,excavated
exceed -> exceeds,exceeding,exceeded
excel -> excels,excelling,excelled
except -> excepts,excepting,excepted
exchange -> exchanges,exchanging,exchanged
excise -> excises,excising,excised
excite -> excites,exciting,excited
exclaim -> exclaims,exclaiming,exclaimed
exclude -> excludes,excluding,excluded
excommunicate -> excommunicates,excommunicating,excommunicated
excrete -> excretes,excreting,excreted
exculpate -> exculpates,exculpating,exculpated
excuse -> excuses,excusing,excused
execute -> executes,executing,executed
exemplify -> exemplifies,exemplifying,exemplified
exempt -> exempts,exempting,exempted
exercise -> exercises,exercising,exercised
exert -> exerts,exerting,exerted
exhale -> exhales,exhaling,exhaled
exhaust -> exhausts,exhausting,exhausted
exhibit -> exhibits,exhibiting,exhibited
exhilarate -> exhilarates,exhilarating,exhilarated
exhort -> exhorts,exhorting,exhorted
exhume -> exhumes,exhuming,exhumed
exile -> exiles,exiling,exiled
exist -> exists,existing,existed
exit -> exits,exiting,exited
exonerate -> exonerates,exonerating,exonerated
exorcize -> exorcizes,exorcizing,exorcized
expand -> expands,expanding,expanded
expatiate -> expatiates,expatiating,expatiated
expect -> expects,expecting,expected
expedite -> expedites,expediting,expedited
expel -> expels,expelling,expelled
expend -> expends,expending,expended
experience -> experiences,experiencing,experienced
experiment -> experiments,experimenting,experimented
expiate -> expiates,expiating,expiated
expire -> expires,expiring,expired
explain -> explains,explaining,explained
explicate -> explicates,explicating,explicated
explode -> explodes,exploding,exploded
exploit -> exploits,exploiting,exploited
explore -> explores,exploring,explored
export -> exports,exporting,exported
expose -> exposes,exposing,exposed
expostulate -> expostulates,expostulating,expostulated
expound -> expounds,expounding,expounded
express -> expresses,expressing,expressed
expropriate -> expropriates,expropriating,expropriated
expunge -> expunges,expunging,expunged
expurgate -> expurgates,expurgating,expurgated
extemporize -> extemporizes,extemporizing,extemporized
extend -> extends,extending,extended
extenuate -> extenuates,extenuating,extenuated
exterminate -> exterminates,exterminating,exterminated
externalize -> externalizes,externalizing,externalized
extinguish -> extinguishes,extinguishing,extinguished
extol -> extols,extolling,extolled
extort -> extorts,extorting,extorted
extract -> extracts,extracting,extracted
extradite -> extradites,extraditing,extradited
extrapolate -> extrapolates,extrapolating,extrapolated
extricate -> extricates,extricating,extricated
extrude -> extrudes,extruding,extruded
exude -> exudes,exuding,exuded
exult -> exults,exulting,exulted
fabricate -> fabricates,fabricating,fabricated
face -> faces,facing,faced
facilitate -> facilitates,facilitating,facilitated
fade -> fades,fading,faded
fag -> fags,fagging,fagged
fail -> fails,failing,failed
faint -> fainter,faintest,faints,fainting,fainted
fair -> fairer,fairest,fairs
fake -> fakes,faking,faked
fall -> falls,falling,fell,fallen
falsify -> falsifies,falsifying,falsified
falter -> falters,faltering,faltered
familiarize -> familiarizes,familiarizing,familiarized
fan -> fans,fanning,fanned
fancy -> fancies,fancying,fancied,fancier,fanciest
fantasize -> fantasizes,fantasizing,fantasized
fare -> fares,faring,fared
farm -> farms,farming,farmed
farrow -> farrows,farrowing,farrowed
fart -> farts,farting,farted
fascinate -> fascinates,fascinating,fascinated
fashion -> fashions,fashioning,fashioned
fast -> faster,fastest,fasts,fasting,fasted
fasten -> fastens,fastening,fastened
fat -> fatter,fattest,fats
father -> fathers,fathering,fathered
fathom -> fathoms,fathoming,fathomed
fatigue -> fatigues,fatiguing,fatigued
fatten -> fattens,fattening,fattened
fatty -> fatties,fattier,fattiest
fault -> faults,faulting,faulted
favour -> favours,favouring,favoured
fawn -> fawns,fawning,fawned
faze -> fazes,fazing,fazed
fear -> fears,fearing,feared
feast -> feasts,feasting,feasted
feather -> feathers,feathering,feathered
feature -> features,featuring,featured
federate -> federates,federating,federated
Fedex -> Fedexes,Fedexing,Fedexed
feed -> feeds,feeding,fed
feel -> feels,feeling,felt
feign -> feigns,feigning,feigned
feint -> feints,feinting,feinted
fell -> fells,felling,felled
fence -> fences,fencing,fenced
fend -> fends,fending,fended
ferment -> ferments,fermenting,fermented
ferret -> ferrets,ferreting,ferreted
ferry -> ferries,ferrying,ferried
fertilize -> fertilizes,fertilizing,fertilized
fester -> festers,festering,festered
festoon -> festoons,festooning,festooned
fetch -> fetches,fetching,fetched
fete -> fetes,feting,feted
fetter -> fetters,fettering,fettered
feud -> feuds,feuding,feuded
fib -> fibs,fibbing,fibbed
fictionalize -> fictionalizes,fictionalizing,fictionalized
fiddle -> fiddles,fiddling,fiddled
fidget -> fidgets,fidgeting,fidgeted
field -> fields,fielding,fielded
field-test -> field-tests,field-testing,field-tested
fight -> fights,fighting,fought
figure -> figures,figuring,figured
filch -> filches,filching,filched
file -> files,filing,filed
filibuster -> filibusters,filibustering,filibustered
fill -> fills,filling,filled
fillet -> fillets,filleting,filleted
film -> films,filming,filmed
filter -> filters,filtering,filtered
finalize -> finalizes,finalizing,finalized
finance -> finances,financing,financed
find -> finds,finding,found
fine -> finer,finest,fines,fining,fined
finger -> fingers,fingering,fingered
fingerprint -> fingerprints,fingerprinting,fingerprinted
finish -> finishes,finishing,finished
fire -> fires,firing,fired
fireproof -> fireproofs,fireproofing,fireproofed
firm -> firmer,firmest,firms,firming,firmed
fish -> fishes,fishing,fished
fit -> fits,fitting,fitted,fitter,fittest
fix -> fixes,fixing,fixed
fizz -> fizzes,fizzing,fizzed
fizzle -> fizzles,fizzling,fizzled
flag -> flags,flagging,flagged
flagellate -> flagellates,flagellating,flagellated
flail -> flails,flailing,flailed
flake -> flakes,flaking,flaked
flambe -> flambes,flambeing,flambeed
flame -> flames,flaming,flamed
flank -> flanks,flanking,flanked
flannel -> flannels,flannelling,flannelled
flap -> flaps,flapping,flapped
flare -> flares,flaring,flared
flash -> flashes,flashing,flashed
flat -> flats,flatter,flattest
flatten -> flattens,flattening,flattened
flatter -> flatters,flattering,flattered
flaunt -> flaunts,flaunting,flaunted
flavour -> flavours,flavouring,flavoured
flay -> flays,flaying,flayed
fleck -> flecks,flecking,flecked
flee -> flees,fleeing,fled
fleece -> fleeces,fleecing,fleeced
flesh -> fleshes,fleshing,fleshed
flex -> flexes,flexing,flexed
flick -> flicks,flicking,flicked
flicker -> flickers,flickering,flickered
flimsy -> flimsier,flimsiest,flimsies
flinch -> flinches,flinching,flinched
fling -> flings,flinging,flung
flip -> flips,flipping,flipped
flirt -> flirts,flirting,flirted
flit -> flits,flitting,flitted
float -> floats,floating,floated
flock -> flocks,flocking,flocked
flog -> flogs,flogging,flogged
flood -> floods,flooding,flooded
floodlight -> floodlights,floodlighting,floodlit
floor -> floors,flooring,floored
flop -> flops,flopping,flopped
flounce -> flounces,flouncing,flounced
flounder -> flounders,floundering,floundered
flour -> flours,flouring,floured
flourish -> flourishes,flourishing,flourished
flout -> flouts,flouting,flouted
flow -> flows,flowing,flowed
flower -> flowers,flowering,flowered
fluctuate -> fluctuates,fluctuating,fluctuated
fluff -> fluffs,fluffing,fluffed
flummox -> flummoxes,flummoxing,flummoxed
flunk -> flunks,flunking,flunked
flush -> flushes,flushing,flushed
fluster -> flusters,flustering,flustered
flutter -> flutters,fluttering,fluttered
fly -> flies,flew,flied,flown,flying
foal -> foals,foaling,foaled
foam -> foams,foaming,foamed
fob -> fobs,fobbing,fobbed
focus -> foci,focuses,focusing,focused
fog -> fogs,fogging,fogged
foil -> foils,foiling,foiled
foist -> foists,foisting,foisted
fold -> folds,folding,folded
follow -> follows,following,followed
foment -> foments,fomenting,fomented
fondle -> fondles,fondling,fondled
fool -> fools,fooling,fooled
foot -> feet,foots,footing,footed
forage -> forages,foraging,foraged
forbear -> forbears,forbearing,forbore,forborne
forbid -> forbids,forbidding,forbade,forbidden
force -> forces,forcing,forced
force-feed -> force-feeds,force-feeding,force-fed
ford -> fords,fording,forded
forecast -> forecasts,forecasting,forecasted
foreclose -> forecloses,foreclosing,foreclosed
forego -> foregoes,foregoing,forewent,foregone
foreknow -> foreknows,foreknew,foreknown,foreknowing
foreordain -> foreordains,foreordaining,foreordained
foresee -> foresees,foreseeing,foresaw,foreseen
foreshadow -> foreshadows,foreshadowing,foreshadowed
foreshorten -> foreshortens,foreshortening,foreshortened
foreshow -> foreshows,foreshowed,foreshown,foreshowing
forestall -> forestalls,forestalling,forestalled
foretell -> foretells,foretelling,foretold
forewarn -> forewarns,forewarning,forewarned
forfeit -> forfeits,forfeiting,forfeited
forge -> forges,forging,forged
forget -> forgets,forgetting,forgot,forgotten
forgive -> forgives,forgiving,forgave,forgiven
forgo -> forgoes,forwent,forgone,forgoing
fork -> forks,forking,forked
form -> forms,forming,formed
formalize -> formalizes,formalizing,formalized
formulate -> formulates,formulating,formulated
fornicate -> fornicates,fornicating,fornicated
forsake -> forsakes,forsaking,forsook,forsaken
forswear -> forswears,forswearing,forswore,forsworn
fortify -> fortifies,fortifying,fortified
forward -> forwards,forwarding,forwarded
fossilize -> fossilizes,fossilizing,fossilized
foster -> fosters,fostering,fostered
foul -> fouls,fouling,fouled,fouler,foulest
found -> founds,founding,founded
founder -> founders,foundering,foundered
fox -> foxes,foxing,foxed
fracture -> fractures,fracturing,fractured
fragment -> fragments,fragmenting,fragmented
frame -> frames,framing,framed
frank -> franker,frankest,franks,franking,franked
fraternize -> fraternizes,fraternizing,fraternized
fray -> frays,fraying,frayed
freak -> freaks,freaking,freaked
free -> frees,freeing,freed,freer,freest
freelance -> freelances,freelancing,freelanced
freewheel -> freewheels,freewheeling,freewheeled
freeze -> freezes,freezing,froze,frozen
freight -> freights,freighting,freighted
frequent -> frequents,frequenting,frequented
freshen -> freshens,freshening,freshened
fret -> frets,fretting,fretted
friendly -> friendlier,friendliest,friendlies
frig -> frigs,frigging,frigged
frighten -> frightens,frightening,frightened
frisk -> frisks,frisking,frisked
fritter -> fritters,frittering,frittered
frizz -> frizzes,frizzing,frizzed
frizzle -> frizzles,frizzling,frizzled
frog-march -> frog-marches,frog-marching,frog-marched
frolic -> frolics,frolicking,frolicked
front -> fronts,fronting,fronted
frost -> frosts,frosting,frosted
froth -> froths,frothing,frothed
frown -> frowns,frowning,frowned
fruit -> fruits,fruiting,fruited
frustrate -> frustrates,frustrating,frustrated
fry -> fries,frying,fried
fuck -> fucks,fucking,fucked
fudge -> fudges,fudging,fudged
fuel -> fuels,fuelling,fuelled
fulfil -> fulfils,fulfilling,fulfilled
fulminate -> fulminates,fulminating,fulminated
fumble -> fumbles,fumbling,fumbled
fume -> fumes,fuming,fumed
fumigate -> fumigates,fumigating,fumigated
function -> functions,functioning,functioned
fund -> funds,funding,funded
funk -> funks,funking,funked
funnel -> funnels,funnelling,funnelled
funny -> funnier,funniest,funnies
fur -> furs,furring,furred
furbish -> furbishes,furbishing,furbished
furl -> furls,furling,furled
furnish -> furnishes,furnishing,furnished
furrow -> furrows,furrowing,furrowed
further -> furthers,furthering,furthered, furtherst
fuse -> fuses,fusing,fused
fuss -> fusses,fussing,fussed
gab -> gabs,gabbing,gabbed
gabble -> gabbles,gabbling,gabbled
gad -> gads,gadding,gadded
gag -> gags,gagging,gagged
gain -> gains,gaining,gained
gainsay -> gainsays,gainsaying,gainsaid
gall -> galls,galling,galled
gallivant -> gallivants,gallivanting,gallivanted
gallop -> gallops,galloping,galloped
galvanize -> galvanizes,galvanizing,galvanized
gamble -> gambles,gambling,gambled
gambol -> gambols,gambolling,gambolled
gang -> gangs,ganging,ganged
gaol -> gaols,gaoling,gaoled
gape -> gapes,gaping,gaped
gargle -> gargles,gargling,gargled
garland -> garlands,garlanding,garlanded
garner -> garners,garnering,garnered
garnish -> garnishes,garnishing,garnished
garrison -> garrisons,garrisoning,garrisoned
garrotte -> garrottes,garrotting,garrotted
gas -> gases,gasses,gassing,gassed
gash -> gashes,gashing,gashed
gasp -> gasps,gasping,gasped
gatecrash -> gatecrashes,gatecrashing,gatecrashed
gather -> gathers,gathering,gathered
gauge -> gauges,gauging,gauged
gawk -> gawks,gawking,gawked
gawp -> gawps,gawping,gawped
gay -> gays,gayer,gayest
gaze -> gazes,gazing,gazed
gazump -> gazumps,gazumping,gazumped
gear -> gears,gearing,geared
gel -> gels,gelling,gelled
gen -> gens,genning,genned
generalize -> generalizes,generalizing,generalized
generate -> generates,generating,generated
genuflect -> genuflects,genuflecting,genuflected
germinate -> germinates,germinating,germinated
gesticulate -> gesticulates,gesticulating,gesticulated
gesture -> gestures,gesturing,gestured
get -> gets,getting,got,gotten
ghost -> ghosts,ghosting,ghosted
ghost-write -> ghost-writes,ghost-writing,ghost-wrote,ghost-written
ghostwrite -> ghostwrites,ghostwrote,ghostwritten,ghostwriting
gibber -> gibbers,gibbering,gibbered
giggle -> giggles,giggling,giggled
gild -> gilds,gilt,gilded,gilding
gird -> girds,girt,girded,girding
girdle -> girdles,girdling,girdled
give -> gives,giving,gave,given
gladden -> gladdens,gladdening,gladdened
glamorize -> glamorizes,glamorizing,glamorized
glance -> glances,glancing,glanced
glare -> glares,glaring,glared
glaze -> glazes,glazing,glazed
gleam -> gleams,gleaming,gleamed
glean -> gleans,gleaning,gleaned
glide -> glides,gliding,glided
glimmer -> glimmers,glimmering,glimmered
glimpse -> glimpses,glimpsing,glimpsed
glint -> glints,glinting,glinted
glisten -> glistens,glistening,glistened
glitter -> glitters,glittering,glittered
gloat -> gloats,gloating,gloated
glorify -> glorifies,glorifying,glorified
glory -> glories,glorying,gloried
gloss -> glosses,glossing,glossed
glow -> glows,glowing,glowed
glower -> glowers,glowering,glowered
glue -> glues,glueing,gluing,glued
glut -> gluts,glutting,glutted
gnash -> gnashes,gnashing,gnashed
gnaw -> gnaws,gnawing,gnawed
go -> goes,going,went,gone
goad -> goads,goading,goaded
gobble -> gobbles,gobbling,gobbled
goggle -> goggles,goggling,goggled
goof -> goofs,goofing,goofed
goose -> geese,gooses,goosing,goosed
goose-step -> goose-steps,goose-stepping,goose-stepped
gore -> gores,goring,gored
gorge -> gorges,gorging,gorged
gossip -> gossips,gossiping,gossiped
gouge -> gouges,gouging,gouged
govern -> governs,governing,governed
grab -> grabs,grabbing,grabbed
grace -> graces,gracing,graced
grade -> grades,grading,graded
graduate -> graduates,graduating,graduated
graft -> grafts,grafting,grafted
grant -> grants,granting,granted
grapple -> grapples,grappling,grappled
grasp -> grasps,grasping,grasped
grass -> grasses,grassing,grassed
grate -> grates,grating,grated
gratify -> gratifies,gratifying,gratified
grave -> graves,graven,graved,graving
gravitate -> gravitates,gravitating,gravitated
graze -> grazes,grazing,grazed
grease -> greases,greasing,greased
great -> greater,greatest,greats
green -> greener,greenest,greens
greet -> greets,greeting,greeted
grey -> greyer,greyest,greys,greying
grieve -> grieves,grieving,grieved
grill -> grills,grilling,grilled
grimace -> grimaces,grimacing,grimaced
grin -> grins,grinning,grinned
grind -> grinds,grinding,ground
grip -> grips,gripping,gripped
gripe -> gripes,griping,griped
grit -> grits,gritting,gritted
grizzle -> grizzles,grizzling,grizzled
groan -> groans,groaning,groaned
groom -> grooms,grooming,groomed
grope -> gropes,groping,groped
gross -> grosses,grossing,grossed,grosser,grossest
grouch -> grouches,grouching,grouched
ground -> grounds,grounding,grounded
group -> groups,grouping,grouped
grouse -> grouses,grousing,groused
grovel -> grovels,grovelling,grovelled
grow -> grows,grew,grown,growing
growl -> growls,growling,growled
grub -> grubs,grubbing,grubbed
grudge -> grudges,grudging,grudged
grumble -> grumbles,grumbling,grumbled
grunt -> grunts,grunting,grunted
guarantee -> guarantees,guaranteeing,guaranteed
guard -> guards,guarding,guarded
guess -> guesses,guessing,guessed
guest -> guests,guesting,guested
guffaw -> guffaws,guffawing,guffawed
guide -> guides,guiding,guided
guillotine -> guillotines,guillotining,guillotined
gulp -> gulps,gulping,gulped
gum -> gums,gumming,gummed
gun -> guns,gunning,gunned
gurgle -> gurgles,gurgling,gurgled
gush -> gushes,gushing,gushed
gust -> gusts,gusting,gusted
gut -> guts,gutting,gutted
gutter -> gutters,guttering,guttered
guzzle -> guzzles,guzzling,guzzled
gyrate -> gyrates,gyrating,gyrated
habituate -> habituates,habituating,habituated
hack -> hacks,hacking,hacked
haemorrhage -> haemorrhages,haemorrhaging,haemorrhaged
haggle -> haggles,haggling,haggled
hail -> hails,hailing,hailed
hallmark -> hallmarks,hallmarking,hallmarked
hallucinate -> hallucinates,hallucinating,hallucinated
halt -> halts,halting,halted
halve -> halves,halving,halved
ham -> hams,hamming,hammed
hammer -> hammers,hammering,hammered
hamper -> hampers,hampering,hampered
hamstring -> hamstrings,hamstringing,hamstrung
hand -> hands,handing,handed
handcuff -> handcuffs,handcuffing,handcuffed
handicap -> handicaps,handicapping,handicapped
handle -> handles,handling,handled
hang -> hangs,hanging,hanged,hung
hanker -> hankers,hankering,hankered
happen -> happens,happening,happened
harangue -> harangues,haranguing,harangued
harass -> harasses,harassing,harassed
harbour -> harbours,harbouring,harboured
harden -> hardens,hardening,hardened
hare -> hares,haring,hared
hark -> harks,harking,harked
harm -> harms,harming,harmed
harmonize -> harmonizes,harmonizing,harmonized
harness -> harnesses,harnessing,harnessed
harp -> harps,harping,harped
harpoon -> harpoons,harpooning,harpooned
harry -> harries,harrying,harried
harvest -> harvests,harvesting,harvested
hassle -> hassles,hassling,hassled
hasten -> hastens,hastening,hastened
hatch -> hatches,hatching,hatched
hate -> hates,hating,hated
haul -> hauls,hauling,hauled
haunt -> haunts,haunting,haunted
have -> has,having,had,'d,'ve,d,ve
haw -> haws,hawing,hawed
hawk -> hawks,hawking,hawked
hazard -> hazards,hazarding,hazarded
head -> heads,heading,headed
headline -> headlines,headlining,headlined
heal -> heals,healing,healed
heap -> heaps,heaping,heaped
hear -> hears,hearing,heard
hearten -> heartens,heartening,heartened
heat -> heats,heating,heated
heave -> heaves,hove,heaved,heaving
heavy -> heavier,heaviest,heavies
heckle -> heckles,heckling,heckled
hector -> hectors,hectoring,hectored
hedge -> hedges,hedging,hedged
heed -> heeds,heeding,heeded
heel -> heels,heeling,heeled
heighten -> heightens,heightening,heightened
help -> helps,helping,helped
hem -> hems,hemming,hemmed
henna -> hennas,hennaing,hennaed
herald -> heralds,heralding,heralded
herd -> herds,herding,herded
hesitate -> hesitates,hesitating,hesitated
hew -> hews,hewing,hewed,hewn
hibernate -> hibernates,hibernating,hibernated
hiccup -> hiccups,hiccupping,hiccupped
hide -> hides,hiding,hid,hidden
high -> higher,highest,highs
highlight -> highlights,highlighting,highlighted
hijack -> hijacks,hijacking,hijacked
hike -> hikes,hiking,hiked
hinder -> hinders,hindering,hindered
hinge -> hinges,hinging,hinged
hink -> hinks,hinking,hinked
hint -> hints,hinting,hinted
hire -> hires,hiring,hired
hiss -> hisses,hissing,hissed
hitch -> hitches,hitching,hitched
hitch-hike -> hitch-hikes,hitch-hiking,hitch-hiked
hive -> hives,hiving,hived
hoard -> hoards,hoarding,hoarded
hoax -> hoaxes,hoaxing,hoaxed
hobble -> hobbles,hobbling,hobbled
hobnob -> hobnobs,hobnobbing,hobnobbed
hoe -> hoes,hoeing,hoed
hog -> hogs,hogging,hogged
hoist -> hoists,hoisting,hoisted
hold -> holds,holding,held
hole -> holes,holing,holed
holiday -> holidays,holidaying,holidayed
holler -> hollers,hollering,hollered
hollow -> hollows,hollowing,hollowed
home -> homes,homing,homed
hone -> hones,honing,honed
honeymoon -> honeymoons,honeymooning,honeymooned
honk -> honks,honking,honked
honour -> honours,honouring,honoured
hoodwink -> hoodwinks,hoodwinking,hoodwinked
hook -> hooks,hooking,hooked
hoot -> hoots,hooting,hooted
hoover -> hoovers,hoovering,hoovered
hop -> hops,hopping,hopped
hope -> hopes,hoping,hoped
horrify -> horrifies,horrifying,horrified
horse -> horses,horsing,horsed
horsewhip -> horsewhips,horsewhipping,horsewhipped
hose -> hoses,hosing,hosed
hospitalize -> hospitalizes,hospitalizing,hospitalized
host -> hosts,hosting,hosted
hot -> hotter,hottest,hots,hotting,hotted
hound -> hounds,hounding,hounded
house -> houses,housing,housed
housetrain -> housetrains,housetraining,housetrained
hover -> hovers,hovering,hovered
howl -> howls,howling,howled
huddle -> huddles,huddling,huddled
huff -> huffs,huffing,huffed
hug -> hugs,hugging,hugged
hull -> hulls,hulling,hulled
hum -> hums,humming,hummed
humanize -> humanizes,humanizing,humanized
humble -> humbler,humblest,humbles,humbling,humbled
humidify -> humidifies,humidifying,humidified
humiliate -> humiliates,humiliating,humiliated
humour -> humours,humouring,humoured
hump -> humps,humping,humped
hunch -> hunches,hunching,hunched
hunger -> hungers,hungering,hungered
hunt -> hunts,hunting,hunted
hurdle -> hurdles,hurdling,hurdled
hurl -> hurls,hurling,hurled
hurry -> hurries,hurrying,hurried
hurtle -> hurtles,hurtling,hurtled
husband -> husbands,husbanding,husbanded
hush -> hushes,hushing,hushed
husk -> husks,husking,husked
hustle -> hustles,hustling,hustled
hydroplane -> hydroplanes,hydroplaning,hydroplaned
hypnotize -> hypnotizes,hypnotizing,hypnotized
ice -> ices,icing,iced
ice-skate -> ice-skates,ice-skating,ice-skated
idealize -> idealizes,idealizing,idealized
identify -> identifies,identifying,identified
idle -> idles,idling,idled
idolize -> idolizes,idolizing,idolized
ignite -> ignites,igniting,ignited
ignore -> ignores,ignoring,ignored
ill-treat -> ill-treats,ill-treating,ill-treated
illuminate -> illuminates,illuminating,illuminated
illumine -> illumines,illumining,illumined
illustrate -> illustrates,illustrating,illustrated
imagine -> imagines,imagining,imagined
imbibe -> imbibes,imbibing,imbibed
imbue -> imbues,imbuing,imbued
imitate -> imitates,imitating,imitated
immerse -> immerses,immersing,immersed
immobilize -> immobilizes,immobilizing,immobilized
immortalize -> immortalizes,immortalizing,immortalized
immunize -> immunizes,immunizing,immunized
impact -> impacts,impacting,impacted
impair -> impairs,impairing,impaired
impale -> impales,impaling,impaled
impart -> imparts,imparting,imparted
impeach -> impeaches,impeaching,impeached
impede -> impedes,impeding,impeded
impel -> impels,impelling,impelled
imperil -> imperils,imperilling,imperilled
impersonate -> impersonates,impersonating,impersonated
impinge -> impinges,impinging,impinged
implant -> implants,implanting,implanted
implement -> implements,implementing,implemented
implicate -> implicates,implicating,implicated
implore -> implores,imploring,implored
imply -> implies,implying,implied
import -> imports,importing,imported
importune -> importunes,importuning,importuned
impose -> imposes,imposing,imposed
impound -> impounds,impounding,impounded
impoverish -> impoverishes,impoverishing,impoverished
impregnate -> impregnates,impregnating,impregnated
impress -> impresses,impressing,impressed
imprint -> imprints,imprinting,imprinted
imprison -> imprisons,imprisoning,imprisoned
improve -> improves,improving,improved
improvise -> improvises,improvising,improvised
impugn -> impugns,impugning,impugned
impute -> imputes,imputing,imputed
inaugurate -> inaugurates,inaugurating,inaugurated
incapacitate -> incapacitates,incapacitating,incapacitated
incarcerate -> incarcerates,incarcerating,incarcerated
incense -> incenses,incensing,incensed
inch -> inches,inching,inched
incinerate -> incinerates,incinerating,incinerated
incise -> incises,incising,incised
incite -> incites,inciting,incited
incline -> inclines,inclining,inclined
include -> includes,including,included
inconvenience -> inconveniences,inconveniencing,inconvenienced
incorporate -> incorporates,incorporating,incorporated
increase -> increases,increasing,increased
incriminate -> incriminates,incriminating,incriminated
incubate -> incubates,incubating,incubated
inculcate -> inculcates,inculcating,inculcated
incur -> incurs,incurring,incurred
indent -> indents,indenting,indented
index -> indexes,indexing,indexed,indices
indicate -> indicates,indicating,indicated
indict -> indicts,indicting,indicted
individualize -> individualizes,individualizing,individualized
indoctrinate -> indoctrinates,indoctrinating,indoctrinated
induce -> induces,inducing,induced
induct -> inducts,inducting,inducted
indulge -> indulges,indulging,indulged
industrialize -> industrializes,industrializing,industrialized
indwell -> indwells,indwelt,indwelling
infect -> infects,infecting,infected
infer -> infers,inferring,inferred
infest -> infests,infesting,infested
infiltrate -> infiltrates,infiltrating,infiltrated
inflame -> inflames,inflaming,inflamed
inflate -> inflates,inflating,inflated
inflect -> inflects,inflecting,inflected
inflict -> inflicts,inflicting,inflicted
influence -> influences,influencing,influenced
inform -> informs,informing,informed
infringe -> infringes,infringing,infringed
infuriate -> infuriates,infuriating,infuriated
infuse -> infuses,infusing,infused
ingratiate -> ingratiates,ingratiating,ingratiated
inhabit -> inhabits,inhabiting,inhabited
inhale -> inhales,inhaling,inhaled
inherit -> inherits,inheriting,inherited
inhibit -> inhibits,inhibiting,inhibited
initial -> initials,initialling,initialled
initiate -> initiates,initiating,initiated
inject -> injects,injecting,injected
injure -> injures,injuring,injured
ink -> inks,inking,inked
inlay -> inlays,inlaying,inlaid
innovate -> innovates,innovating,innovated
inoculate -> inoculates,inoculating,inoculated
input -> inputs,inputted,inputting
inquire -> inquires,inquiring,inquired
inscribe -> inscribes,inscribing,inscribed
inseminate -> inseminates,inseminating,inseminated
insert -> inserts,inserting,inserted
inset -> insets,insetted,insetting
insinuate -> insinuates,insinuating,insinuated
insist -> insists,insisting,insisted
inspect -> inspects,inspecting,inspected
inspire -> inspires,inspiring,inspired
install -> installs,installing,installed
instigate -> instigates,instigating,instigated
instil -> instils,instilling,instilled
institute -> institutes,instituting,instituted
institutionalize -> institutionalizes,institutionalizing,institutionalized
instruct -> instructs,instructing,instructed
insulate -> insulates,insulating,insulated
insult -> insults,insulting,insulted
insure -> insures,insuring,insured
integrate -> integrates,integrating,integrated
intend -> intends,intending,intended
intensify -> intensifies,intensifying,intensified
inter -> inters,interring,interred
interact -> interacts,interacting,interacted
intercede -> intercedes,interceding,interceded
intercept -> intercepts,intercepting,intercepted
interchange -> interchanges,interchanging,interchanged
interconnect -> interconnects,interconnecting,interconnected
interest -> interests,interesting,interested
interfere -> interferes,interfering,interfered
interject -> interjects,interjecting,interjected
interlink -> interlinks,interlinking,interlinked
interlock -> interlocks,interlocking,interlocked
intermarry -> intermarries,intermarrying,intermarried
intermingle -> intermingles,intermingling,intermingled
intern -> interns,interning,interned
internalize -> internalizes,internalizing,internalized
interpolate -> interpolates,interpolating,interpolated
interpose -> interposes,interposing,interposed
interpret -> interprets,interpreting,interpreted
interrelate -> interrelates,interrelating,interrelated
interrogate -> interrogates,interrogating,interrogated
interrupt -> interrupts,interrupting,interrupted
intersect -> intersects,intersecting,intersected
intersperse -> intersperses,interspersing,interspersed
intertwine -> intertwines,intertwining,intertwined
intervene -> intervenes,intervening,intervened
interview -> interviews,interviewing,interviewed
interweave -> interweaves,interweaving,interwove,interwoven
intimate -> intimates,intimating,intimated
intimidate -> intimidates,intimidating,intimidated
intone -> intones,intoning,intoned
intrigue -> intrigues,intriguing,intrigued
introduce -> introduces,introducing,introduced
intrude -> intrudes,intruding,intruded
intuit -> intuits,intuiting,intuited
inundate -> inundates,inundating,inundated
inure -> inures,inuring,inured
invade -> invades,invading,invaded
invalidate -> invalidates,invalidating,invalidated
inveigh -> inveighs,inveighing,inveighed
inveigle -> inveigles,inveigling,inveigled
invent -> invents,inventing,invented
invert -> inverts,inverting,inverted
invest -> invests,investing,invested
investigate -> investigates,investigating,investigated
invigilate -> invigilates,invigilating,invigilated
invite -> invites,inviting,invited
invoice -> invoices,invoicing,invoiced
invoke -> invokes,invoking,invoked
involve -> involves,involving,involved
irk -> irks,irking,irked
iron -> irons,ironing,ironed
irradiate -> irradiates,irradiating,irradiated
irrigate -> irrigates,irrigating,irrigated
irritate -> irritates,irritating,irritated
isolate -> isolates,isolating,isolated
issue -> issues,issuing,issued
itch -> itches,itching,itched
itemize -> itemizes,itemizing,itemized
jab -> jabs,jabbing,jabbed
jabber -> jabbers,jabbering,jabbered
jack -> jacks,jacking,jacked
jack-knife -> jack-knifes,jack-knifing,jack-knifed,jack-knives
jail -> jails,jailing,jailed
jam -> jams,jamming,jammed
jangle -> jangles,jangling,jangled
jar -> jars,jarring,jarred
jaunt -> jaunts,jaunting,jaunted
jaw -> jaws,jawing,jawed
jazz -> jazzes,jazzing,jazzed
jeer -> jeers,jeering,jeered
jeopardize -> jeopardizes,jeopardizing,jeopardized
jerk -> jerks,jerking,jerked
jerry-build -> jerry-builds,jerry-building,jerry-built
jest -> jests,jesting,jested
jet -> jets,jetting,jetted
jettison -> jettisons,jettisoning,jettisoned
jib -> jibs,jibbing,jibbed
jig -> jigs,jigging,jigged
jiggle -> jiggles,jiggling,jiggled
jigsaw -> jigsaws,jigsawn,jigsawed,jigsawing
jilt -> jilts,jilting,jilted
jingle -> jingles,jingling,jingled
jink -> jinks,jinking,jinked
jive -> jives,jiving,jived
jockey -> jockeys,jockeying,jockeyed
jog -> jogs,jogging,jogged
joggle -> joggles,joggling,joggled
join -> joins,joining,joined
joke -> jokes,joking,joked
jolt -> jolts,jolting,jolted
jostle -> jostles,jostling,jostled
jot -> jots,jotting,jotted
journey -> journeys,journeying,journeyed
joust -> jousts,jousting,jousted
joyride -> joyrides,joyriding,joyrode,joyridden
judder -> judders,juddering,juddered
judge -> judges,judging,judged
juggle -> juggles,juggling,juggled
jumble -> jumbles,jumbling,jumbled
jump -> jumps,jumping,jumped
justify -> justifies,justifying,justified
jut -> juts,jutting,jutted
juxtapose -> juxtaposes,juxtaposing,juxtaposed
keel -> keels,keeling,keeled
keen -> keener,keenest,keens,keening,keened
keep -> keeps,keeping,kept
key -> keys,keying,keyed
kick -> kicks,kicking,kicked
kid -> kids,kidding,kidded
kidnap -> kidnaps,kidnapping,kidnapped
kill -> kills,killing,killed
kind -> kinds,kinder,kindest
kindle -> kindles,kindling,kindled
kink -> kinks,kinking,kinked
kip -> kips,kipping,kipped
kiss -> kisses,kissing,kissed
kit -> kits,kitting,kitted
knead -> kneads,kneading,kneaded
knee -> knees,kneeing,kneed
kneecap -> kneecaps,kneecapping,kneecapped
kneel -> kneels,kneeling,kneeled,knelt
knife -> knives,knifes,knifing,knifed
knight -> knights,knighting,knighted
knit -> knits,knitting,knitted
knock -> knocks,knocking,knocked
knot -> knots,knotting,knotted
know -> knows,knowing,knew,known
knuckle -> knuckles,knuckling,knuckled
kow-tow -> kow-tows,kow-towing,kow-towed
label -> labels,labelling,labelled
labour -> labours,labouring,laboured
lace -> laces,lacing,laced
lacerate -> lacerates,lacerating,lacerated
lack -> lacks,lacking,lacked
lacquer -> lacquers,lacquering,lacquered
ladder -> ladders,laddering,laddered
lade -> lades,laden,laded,lading
ladle -> ladles,ladling,ladled
lag -> lags,lagging,lagged
lam -> lams,lamming,lammed
lament -> laments,lamenting,lamented
lampoon -> lampoons,lampooning,lampooned
lance -> lances,lancing,lanced
land -> lands,landing,landed
landscape -> landscapes,landscaping,landscaped
languish -> languishes,languishing,languished
lap -> laps,lapping,lapped
lapse -> lapses,lapsing,lapsed
lard -> lards,larding,larded
lark -> larks,larking,larked
lash -> lashes,lashing,lashed
lasso -> lassoes,lassoing,lassoed
last -> lasts,lasting,lasted
latch -> latches,latching,latched
lather -> lathers,lathering,lathered
laud -> lauds,lauding,lauded
laugh -> laughs,laughing,laughed
launch -> launches,launching,launched
launder -> launders,laundering,laundered
lavish -> lavishes,lavishing,lavished
lay -> lays,laying,laid
laze -> lazes,lazing,lazed
lead -> leads,leading,led
leaf -> leaves,leafs,leafing,leafed
leaflet -> leaflets,leafleting,leafleted
leak -> leaks,leaking,leaked
lean -> leans,leant,leaned,leant,leaning
leap -> leaps,leaping,leaped,leapt
leapfrog -> leapfrogs,leapfrogging,leapfrogged
learn -> learns,learning,learned,learnt
lease -> leases,leasing,leased
leave -> leaves,leaving,left
lecture -> lectures,lecturing,lectured
leer -> leers,leering,leered
leg -> legs,legging,legged
legalize -> legalizes,legalizing,legalized
legislate -> legislates,legislating,legislated
legitimate -> legitimates,legitimating,legitimated
legitimize -> legitimizes,legitimizing,legitimized
lend -> lends,lending,lent
lengthen -> lengthens,lengthening,lengthened
lessen -> lessens,lessening,lessened
level -> levels,levelling,levelled
lever -> levers,levering,levered
levitate -> levitates,levitating,levitated
levy -> levies,levying,levied
liaise -> liaises,liaising,liaised
libel -> libels,libelling,libelled
liberalize -> liberalizes,liberalizing,liberalized
liberate -> liberates,liberating,liberated
license -> licenses,licensing,licensed
lick -> licks,licking,licked
lie -> lies,lying,lay,lain,lied
lift -> lifts,lifting,lifted
light -> lights,lighting,lighted,lit
lighten -> lightens,lightening,lightened
like -> likes,liking,liked
liken -> likens,likening,likened
limber -> limbers,limbering,limbered
limit -> limits,limiting,limited
limp -> limps,limping,limped,limper,limpest
line -> lines,lining,lined
linger -> lingers,lingering,lingered
link -> links,linking,linked
liquefy -> liquefies,liquefying,liquefied
liquidate -> liquidates,liquidating,liquidated
liquidize -> liquidizes,liquidizing,liquidized
lisp -> lisps,lisping,lisped
list -> lists,listing,listed
listen -> listens,listening,listened
litter -> litters,littering,littered
live -> lives,living,lived
load -> loads,loading,loaded
loaf -> loaves,loafs,loafing,loafed
loan -> loans,loaning,loaned
loathe -> loathes,loathing,loathed
lob -> lobs,lobbing,lobbed
lobby -> lobbies,lobbying,lobbied
localize -> localizes,localizing,localized
locate -> locates,locating,located
lock -> locks,locking,locked
lodge -> lodges,lodging,lodged
loft -> lofts,lofting,lofted
log -> logs,logging,logged
loiter -> loiters,loitering,loitered
loll -> lolls,lolling,lolled
lollop -> lollops,lolloping,lolloped
long -> longs,longing,longed,longer,longest
look -> looks,looking,looked
loom -> looms,looming,loomed
loony -> loonier,looniest,loonies
loop -> loops,looping,looped
loose -> looser,loosest,looses,loosing,loosed
loosen -> loosens,loosening,loosened
loot -> loots,looting,looted
lop -> lops,lopping,lopped
lope -> lopes,loping,loped
lord -> lords,lording,lorded
lose -> loses,losing,lost
lounge -> lounges,lounging,lounged
louse -> lice,louses,lousing,loused
love -> loves,loving,loved
low -> lower,lowest,lows,lowing,lowed
lower -> lowers,lowering,lowered
lubricate -> lubricates,lubricating,lubricated
lug -> lugs,lugging,lugged
lull -> lulls,lulling,lulled
lumber -> lumbers,lumbering,lumbered
lump -> lumps,lumping,lumped
lunch -> lunches,lunching,lunched
lunge -> lunges,lunging,lunged
lurch -> lurches,lurching,lurched
lure -> lures,luring,lured
lurk -> lurks,lurking,lurked
lust -> lusts,lusting,lusted
luxuriate -> luxuriates,luxuriating,luxuriated
lynch -> lynchs,lynching,lynched
machine -> machines,machining,machined
madden -> maddens,maddening,maddened
magic -> magics,magicking,magicked
magnetize -> magnetizes,magnetizing,magnetized
magnify -> magnifies,magnifying,magnified
mail -> mails,mailing,mailed
maim -> maims,maiming,maimed
mainline -> mainlines,mainlining,mainlined
maintain -> maintains,maintaining,maintained
major -> majors,majoring,majored
make -> makes,making,made
malfunction -> malfunctions,malfunctioning,malfunctioned
malign -> maligns,maligning,maligned
malinger -> malingers,malingering,malingered
maltreat -> maltreats,maltreating,maltreated
man -> men,mans,manning,manned
manacle -> manacles,manacling,manacled
manage -> manages,managing,managed
mangle -> mangles,mangling,mangled
manhandle -> manhandles,manhandling,manhandled
manicure -> manicures,manicuring,manicured
manifest -> manifests,manifesting,manifested
manipulate -> manipulates,manipulating,manipulated
manoeuvre -> manoeuvres,manoeuvring,manoeuvred
manufacture -> manufactures,manufacturing,manufactured
map -> maps,mapping,mapped
mar -> mars,marring,marred
march -> marches,marching,marched
marinade -> marinades,marinading,marinaded
marinate -> marinates,marinating,marinated
mark -> marks,marking,marked
market -> markets,marketing,marketed
maroon -> maroons,marooning,marooned
marry -> marries,marrying,married
marshal -> marshals,marshalling,marshalled
martyr -> martyrs,martyring,martyred
marvel -> marvels,marvelling,marvelled
mash -> mashes,mashing,mashed
mask -> masks,masking,masked
masquerade -> masquerades,masquerading,masqueraded
mass -> masses,massing,massed
mass-produce -> mass-produces,mass-producing,mass-produced
massacre -> massacres,massacring,massacred
massage -> massages,massaging,massaged
master -> masters,mastering,mastered
mastermind -> masterminds,masterminding,masterminded
masticate -> masticates,masticating,masticated
masturbate -> masturbates,masturbating,masturbated
match -> matches,matching,matched
mate -> mates,mating,mated
materialize -> materializes,materializing,materialized
matriculate -> matriculates,matriculating,matriculated
matter -> matters,mattering,mattered
mature -> matures,maturing,matured,maturer,maturest
maul -> mauls,mauling,mauled
maximize -> maximizes,maximizing,maximized
mean -> means,meaning,meant
meander -> meanders,meandering,meandered
measure -> measures,measuring,measured
mechanize -> mechanizes,mechanizing,mechanized
meddle -> meddles,meddling,meddled
mediate -> mediates,mediating,mediated
meditate -> meditates,meditating,meditated
meet -> meets,met,meeting
mellow -> mellows,mellowing,mellowed
melt -> melts,melted,molten,melting
memorize -> memorizes,memorizing,memorized
menace -> menaces,menacing,menaced
mend -> mends,mending,mended
menstruate -> menstruates,menstruating,menstruated
mention -> mentions,mentioning,mentioned
merge -> merges,merging,merged
merit -> merits,meriting,merited
mesh -> meshes,meshing,meshed
mesmerize -> mesmerizes,mesmerizing,mesmerized
mess -> messes,messing,messed
metamorphose -> metamorphoses,metamorphosing,metamorphosed
mete -> metes,meting,meted
meter -> meters,metering,metered
mew -> mews,mewing,mewed
miaow -> miaows,miaowing,miaowed
microfilm -> microfilms,microfilming,microfilmed
migrate -> migrates,migrating,migrated
militate -> militates,militating,militated
milk -> milks,milking,milked
mill -> mills,milling,milled
mime -> mimes,miming,mimed
Mimeograph -> Mimeographs,Mimeographing,Mimeographed
mimic -> mimics,mimicking,mimicked
mince -> minces,mincing,minced
mind -> minds,minding,minded
mine -> mines,mining,mined
mingle -> mingles,mingling,mingled
miniaturize -> miniaturizes,miniaturizing,miniaturized
minimize -> minimizes,minimizing,minimized
minister -> ministers,ministering,ministered
mint -> mints,minting,minted
minute -> minutes,minuting,minuted,minutest
mirror -> mirrors,mirroring,mirrored
misapply -> misapplies,misapplying,misapplied
misapprehend -> misapprehends,misapprehending,misapprehended
misappropriate -> misappropriates,misappropriating,misappropriated
misbecome -> misbecame,misbecomes,misbecoming
misbehave -> misbehaves,misbehaving,misbehaved
miscalculate -> miscalculates,miscalculating,miscalculated
miscarry -> miscarries,miscarrying,miscarried
misconstrue -> misconstrues,misconstruing,misconstrued
misdeal -> misdeals,misdealt,misdealing
misdirect -> misdirects,misdirecting,misdirected
misdo -> misdoes,misdid,misdone,misdoing
misfire -> misfires,misfiring,misfired
mishandle -> mishandles,mishandling,mishandled
mishear -> mishears,mishearing,misheard
misinform -> misinforms,misinforming,misinformed
misinterpret -> misinterprets,misinterpreting,misinterpreted
misjudge -> misjudges,misjudging,misjudged
mislay -> mislays,mislaying,mislaid
mislead -> misleads,misleading,misled
mismanage -> mismanages,mismanaging,mismanaged
mispronounce -> mispronounces,mispronouncing,mispronounced
misquote -> misquotes,misquoting,misquoted
misrepresent -> misrepresents,misrepresenting,misrepresented
misrule -> misrules,misruling,misruled
miss -> misses,missing,missed
misspell -> misspells,misspelling,misspelled,misspelt
misspend -> misspends,misspending,misspent
mist -> mists,misting,misted
mistake -> mistakes,mistaking,mistook,mistaken
mistime -> mistimes,mistiming,mistimed
mistreat -> mistreats,mistreating,mistreated
mistrust -> mistrusts,mistrusting,mistrusted
misunderstand -> misunderstands,misunderstood,misunderstanding
misuse -> misuses,misusing,misused
mitigate -> mitigates,mitigating,mitigated
mix -> mixes,mixing,mixed
moan -> moans,moaning,moaned
mob -> mobs,mobbing,mobbed
mobilize -> mobilizes,mobilizing,mobilized
mock -> mocks,mocking,mocked
model -> models,modelling,modelled
moderate -> moderates,moderating,moderated
modernize -> modernizes,modernizing,modernized
modify -> modifies,modifying,modified
modulate -> modulates,modulating,modulated
moisten -> moistens,moistening,moistened
molest -> molests,molesting,molested
mollify -> mollifies,mollifying,mollified
mollycoddle -> mollycoddles,mollycoddling,mollycoddled
monitor -> monitors,monitoring,monitored
monkey -> monkeys,monkeying,monkeyed
monopolize -> monopolizes,monopolizing,monopolized
moo -> moos,mooing,mooed
mooch -> mooches,mooching,mooched
moon -> moons,mooning,mooned
moonlight -> moonlights,moonlighting,moonlighted
moor -> moors,mooring,moored
mop -> mops,mopping,mopped
mope -> mopes,moping,moped
moralize -> moralizes,moralizing,moralized
mortgage -> mortgages,mortgaging,mortgaged
mortify -> mortifies,mortifying,mortified
mosey -> moseys,moseying,moseyed
mother -> mothers,mothering,mothered
motion -> motions,motioning,motioned
motivate -> motivates,motivating,motivated
motor -> motors,motoring,motored
mould -> moulds,moulding,moulded
moulder -> moulders,mouldering,mouldered
moult -> moults,moulting,moulted
mount -> mounts,mounting,mounted
mourn -> mourns,mourning,mourned
mouth -> mouths,mouthing,mouthed
move -> moves,moving,moved
mow -> mows,mowing,mowed,mown
muck -> mucks,mucking,mucked
muddle -> muddles,muddling,muddled
muddy -> muddier,muddiest,muddies,muddying,muddied
muff -> muffs,muffing,muffed
muffle -> muffles,muffling,muffled
mug -> mugs,mugging,mugged
mulch -> mulches,mulching,mulched
mull -> mulls,mulling,mulled
multiply -> multiplies,multiplying,multiplied
mumble -> mumbles,mumbling,mumbled
mummify -> mummifies,mummifying,mummified
munch -> munches,munching,munched
murder -> murders,murdering,murdered
murmur -> murmurs,murmuring,murmured
muscle -> muscles,muscling,muscled
muse -> muses,musing,mused
mushroom -> mushrooms,mushrooming,mushroomed
muster -> musters,mustering,mustered
mutate -> mutates,mutating,mutated
mute -> mutes,muting,muted
mutilate -> mutilates,mutilating,mutilated
mutiny -> mutinies,mutinying,mutinied
mutter -> mutters,muttering,muttered
muzzle -> muzzles,muzzling,muzzled
mystify -> mystifies,mystifying,mystified
nab -> nabs,nabbing,nabbed
nag -> nags,nagging,nagged
nail -> nails,nailing,nailed
name -> names,naming,named
nap -> naps,napping,napped
napalm -> napalms,napalming,napalmed
narrate -> narrates,narrating,narrated
narrow -> narrower,narrowest,narrows,narrowing,narrowed
nationalize -> nationalizes,nationalizing,nationalized
natter -> natters,nattering,nattered
naturalize -> naturalizes,naturalizing,naturalized
nauseate -> nauseates,nauseating,nauseated
navigate -> navigates,navigating,navigated
near -> nearer,nearest,nears,nearing,neared
necessitate -> necessitates,necessitating,necessitated
neck -> necks,necking,necked
need -> needs,needing,needed
needle -> needles,needling,needled
negate -> negates,negating,negated
neglect -> neglects,neglecting,neglected
negotiate -> negotiates,negotiating,negotiated
neigh -> neighs,neighing,neighed
nerve -> nerves,nerving,nerved
nest -> nests,nesting,nested
nestle -> nestles,nestling,nestled
net -> nets,netting,netted
network -> networks,networking,networked
neuter -> neuters,neutering,neutered
neutralize -> neutralizes,neutralizing,neutralized
nibble -> nibbles,nibbling,nibbled
nick -> nicks,nicking,nicked
nickname -> nicknames,nicknaming,nicknamed
niggle -> niggles,niggling,niggled
nip -> nips,nipping,nipped
nobble -> nobbles,nobbling,nobbled
noble -> nobler,noblest,nobles
nod -> nods,nodding,nodded
nominate -> nominates,nominating,nominated
normalize -> normalizes,normalizing,normalized
nose -> noses,nosing,nosed
nosedive -> nosedives,nosediving,nosedived
notch -> notches,notching,notched
note -> notes,noting,noted
notice -> notices,noticing,noticed
notify -> notifies,notifying,notified
nourish -> nourishes,nourishing,nourished
nudge -> nudges,nudging,nudged
nuke -> nukes,nuking,nuked
nullify -> nullifies,nullifying,nullified
numb -> numbs,numbing,numbed
number -> numbers,numbering,numbered
nurse -> nurses,nursing,nursed
nurture -> nurtures,nurturing,nurtured
nuzzle -> nuzzles,nuzzling,nuzzled
obey -> obeys,obeying,obeyed
obfuscate -> obfuscates,obfuscating,obfuscated
object -> objects,objecting,objected
oblige -> obliges,obliging,obliged
obliterate -> obliterates,obliterating,obliterated
obscure -> obscures,obscuring,obscured,obscurer,obscurest
observe -> observes,observing,observed
obsess -> obsesses,obsessing,obsessed
obstruct -> obstructs,obstructing,obstructed
obtain -> obtains,obtaining,obtained
obtrude -> obtrudes,obtruding,obtruded
obviate -> obviates,obviating,obviated
occasion -> occasions,occasioning,occasioned
occupy -> occupies,occupying,occupied
occur -> occurs,occurring,occurred
odd -> odder,oddest,odds
odd -> odder,oddest,odds
offend -> offends,offending,offended
offer -> offers,offering,offered
officiate -> officiates,officiating,officiated
offload -> offloads,offloading,offloaded
offset -> offsets,offsetting,offset
ogle -> ogles,ogling,ogled
oil -> oils,oiling,oiled
okay -> okays,okaying,okayed
omit -> omits,omitting,omitted
ooze -> oozes,oozing,oozed
open -> opens,opening,opened
operate -> operates,operating,operated
oppose -> opposes,opposing,opposed
oppress -> oppresses,oppressing,oppressed
opt -> opts,opting,opted
orbit -> orbits,orbiting,orbited
orchestrate -> orchestrates,orchestrating,orchestrated
ordain -> ordains,ordaining,ordained
order -> orders,ordering,ordered
organize -> organizes,organizing,organized
orient -> orients,orienting,oriented
orientate -> orientates,orientating,orientated
originate -> originates,originating,originated
ornament -> ornaments,ornamenting,ornamented
oscillate -> oscillates,oscillating,oscillated
ossify -> ossifies,ossifying,ossified
ostracize -> ostracizes,ostracizing,ostracized
oust -> ousts,ousting,ousted
outbid -> outbids,outbidding,outbidded,outbid
outclass -> outclasses,outclassing,outclassed
outdistance -> outdistances,outdistancing,outdistanced
outdo -> outdoes,outdoing,outdid,outdone
outfight -> outfights,outfought,outfighting
outflank -> outflanks,outflanking,outflanked
outfox -> outfoxes,outfoxing,outfoxed
outgrow -> outgrows,outgrowing,outgrew,outgrown
outlast -> outlasts,outlasting,outlasted
outlaw -> outlaws,outlawing,outlawed
outlay -> outlays,outlaid,outlaying
outline -> outlines,outlining,outlined
outlive -> outlives,outliving,outlived
outmanoeuvre -> outmanoeuvres,outmanoeuvring,outmanoeuvred
outnumber -> outnumbers,outnumbering,outnumbered
output -> outputs,outputting,output
outrage -> outrages,outraging,outraged
outride -> outrides,outrode,outridden,outriding
outrun -> outruns,outrunning,outran
outsell -> outsells,outselling,outsold
outshine -> outshines,outshining,outshone
outsmart -> outsmarts,outsmarting,outsmarted
outstay -> outstays,outstaying,outstayed
outstrip -> outstrips,outstripping,outstripped
outvote -> outvotes,outvoting,outvoted
outwear -> outwears,outwore,outworn,outwearing
outweigh -> outweighs,outweighing,outweighed
outwit -> outwits,outwitting,outwitted
overact -> overacts,overacting,overacted
overawe -> overawes,overawing,overawed
overbalance -> overbalances,overbalancing,overbalanced
overbear -> overbears,overbore,overborne,overbearing
overcharge -> overcharges,overcharging,overcharged
overcome -> overcomes,overcoming,overcame
overdo -> overdoes,overdoing,overdid,overdone
overdraw -> overdraws,overdrew,overdrawn,overdrawing
overeat -> overeats,overate,overeaten,overeating
overemphasize -> overemphasizes,overemphasizing,overemphasized
overestimate -> overestimates,overestimating,overestimated
overfeed -> overfeeds,overfed,overfeeding
overflow -> overflows,overflowing,overflowed
overfly -> overflies,overflew,overflown,overflying
overhang -> overhangs,overhanged,overhung,overhanging
overhaul -> overhauls,overhauling,overhauled
overhear -> overhears,overhearing,overheard
overheat -> overheats,overheating,overheated
overlap -> overlaps,overlapping,overlapped
overlay -> overlays,overlaying,overlaid
overleap -> overleaps,overleapt,overleaped,overleaping
overlie -> overlies,overlay,overlain,overlying
overload -> overloads,overloading,overloaded
overlook -> overlooks,overlooking,overlooked
overpay -> overpays,overpaid,overpaying
overplay -> overplays,overplaying,overplayed
overpower -> overpowers,overpowering,overpowered
overrate -> overrates,overrating,overrated
overreach -> overreaches,overreaching,overreached
overreact -> overreacts,overreacting,overreacted
override -> overrides,overriding,overrode,overridden
overrule -> overrules,overruling,overruled
overrun -> overruns,overrunning,overran,overrun
oversee -> oversees,overseeing,oversaw,overseen
oversell -> oversells,overselling,oversold
overshadow -> overshadows,overshadowing,overshadowed
overshoot -> overshoots,overshooting,overshot
oversimplify -> oversimplifies,oversimplifying,oversimplified
oversleep -> oversleeps,oversleeping,overslept
overspend -> overspends,overspent,overspending
overstate -> overstates,overstating,overstated
overstay -> overstays,overstaying,overstayed
overstep -> oversteps,overstepping,overstepped
overtake -> overtakes,overtaking,overtook,overtaken
overtax -> overtaxes,overtaxing,overtaxed
overthrow -> overthrows,overthrowing,overthrew,overthrown
overturn -> overturns,overturning,overturned
overvalue -> overvalues,overvaluing,overvalued
overwhelm -> overwhelms,overwhelming,overwhelmed
overwork -> overworks,overworking,overworked
overwrite -> overwrites,overwrote,overwritten,overwriting
ovulate -> ovulates,ovulating,ovulated
owe -> owes,owing,owed
own -> owns,owning,owned
oxidize -> oxidizes,oxidizing,oxidized
oxygenate -> oxygenates,oxygenating,oxygenated
pace -> paces,pacing,paced
pacify -> pacifies,pacifying,pacified
pack -> packs,packing,packed
package -> packages,packaging,packaged
pad -> pads,padding,padded
paddle -> paddles,paddling,paddled
padlock -> padlocks,padlocking,padlocked
page -> pages,paging,paged
pain -> pains,paining,pained
paint -> paints,painting,painted
pair -> pairs,pairing,paired
pal -> pals,palling,palled
pale -> paler,palest,pales,paling,paled
pall -> palls,palling,palled
palm -> palms,palming,palmed
palpitate -> palpitates,palpitating,palpitated
pamper -> pampers,pampering,pampered
pan -> pans,panning,panned
pander -> panders,pandering,pandered
panel -> panels,panelling,panelled
panic -> panics,panicking,panicked
pant -> pants,panting,panted
paper -> papers,papering,papered
parachute -> parachutes,parachuting,parachuted
parade -> parades,parading,paraded
parallel -> parallels,paralleling,paralleled
paralyse -> paralyses,paralysing,paralysed
paraphrase -> paraphrases,paraphrasing,paraphrased
parboil -> parboils,parboiling,parboiled
parcel -> parcels,parcelling,parcelled
parch -> parches,parching,parched
pardon -> pardons,pardoning,pardoned
pare -> pares,paring,pared
park -> parks,parking,parked
parley -> parleys,parleying,parleyed
parody -> parodies,parodying,parodied
parrot -> parrots,parroting,parroted
parry -> parries,parrying,parried
parse -> parses,parsing,parsed
part -> parts,parting,parted
partake -> partakes,partaking,partook,partaken
participate -> participates,participating,participated
particularize -> particularizes,particularizing,particularized
partition -> partitions,partitioning,partitioned
partner -> partners,partnering,partnered
pass -> passes,passing,passed
passivize -> passivizes,passivizing,passivized
paste -> pastes,pasting,pasted
pasteurize -> pasteurizes,pasteurizing,pasteurized
pasture -> pastures,pasturing,pastured
pasty -> pastier,pastiest,pasties
pat -> pats,patting,patted
patch -> patches,patching,patched
patent -> patents,patenting,patented
patrol -> patrols,patrolling,patrolled
patronize -> patronizes,patronizing,patronized
patter -> patters,pattering,pattered
pattern -> patterns,patterning,patterned
pauperize -> pauperizes,pauperizing,pauperize
pause -> pauses,pausing,paused
pave -> paves,paving,paved
paw -> paws,pawing,pawed
pawn -> pawns,pawning,pawned
pay -> pays,paying,paid
peak -> peaks,peaking,peaked
peal -> peals,pealing,pealed
peck -> pecks,pecking,pecked
pedal -> pedals,pedalling,pedalled
peddle -> peddles,peddling,peddled
pedestrianize -> pedestrianizes,pedestrianizing,pedestrianized
pee -> pees,peeing,peed
peek -> peeks,peeking,peeked
peel -> peels,peeling,peeled
peep -> peeps,peeping,peeped
peer -> peers,peering,peered
peeve -> peeves,peeving,peeved
peg -> pegs,pegging,pegged
pelt -> pelts,pelting,pelted
pen -> pens,penned,pent,penning
penalize -> penalizes,penalizing,penalized
pencil -> pencils,pencilling,pencilled
penetrate -> penetrates,penetrating,penetrated
pension -> pensions,pensioning,pensioned
people -> peoples,peopling,peopled
pep -> peps,pepping,pepped
pepper -> peppers,peppering,peppered
perambulate -> perambulates,perambulating,perambulated
perceive -> perceives,perceiving,perceived
perch -> perches,perching,perched
percolate -> percolates,percolating,percolated
perfect -> perfects,perfecting,perfected
perforate -> perforates,perforating,perforated
perform -> performs,performing,performed
perish -> perishes,perishing,perished
perjure -> perjures,perjuring,perjured
perk -> perks,perking,perked
perm -> perms,perming,permed
permeate -> permeates,permeating,permeated
permit -> permits,permitting,permitted
perpetrate -> perpetrates,perpetrating,perpetrated
perpetuate -> perpetuates,perpetuating,perpetuated
perplex -> perplexes,perplexing,perplexed
persecute -> persecutes,persecuting,persecuted
persevere -> perseveres,persevering,persevered
persist -> persists,persisting,persisted
personalize -> personalizes,personalizing,personalized
personify -> personifies,personifying,personified
perspire -> perspires,perspiring,perspired
persuade -> persuades,persuading,persuaded
pertain -> pertains,pertaining,pertained
perturb -> perturbs,perturbing,perturbed
peruse -> peruses,perusing,perused
pervade -> pervades,pervading,pervaded
pervert -> perverts,perverting,perverted
pester -> pesters,pestering,pestered
pet -> pets,petting,petted
peter -> peters,petering,petered
petition -> petitions,petitioning,petitioned
petrify -> petrifies,petrifying,petrified
phase -> phases,phasing,phased
philosophize -> philosophizes,philosophizing,philosophized
phone -> phones,phoning,phoned
photocopy -> photocopies,photocopying,photocopied
photograph -> photographs,photographing,photographed
photostat -> photostats,photostating,photostated
phrase -> phrases,phrasing,phrased
pick -> picks,picking,picked
picket -> pickets,picketing,picketed
pickle -> pickles,pickling,pickled
picnic -> picnics,picnicking,picnicked
picture -> pictures,picturing,pictured
piddle -> piddles,piddling,piddled
piece -> pieces,piecing,pieced
pierce -> pierces,piercing,pierced
pig -> pigs,pigging,pigged
pigeon-hole -> pigeon-holes,pigeon-holing,pigeon-holed
pile -> piles,piling,piled
pilfer -> pilfers,pilfering,pilfered
pillage -> pillages,pillaging,pillaged
pillory -> pillories,pillorying,pilloried
pillow -> pillows,pillowing,pillowed
pilot -> pilots,piloting,piloted
pin -> pins,pinning,pinned
pinch -> pinches,pinching,pinched
pine -> pines,pining,pined
ping -> pings,pinging,pinged
pinion -> pinions,pinioning,pinioned
pink -> pinker,pinkest,pinks,pinking,pinked
pinpoint -> pinpoints,pinpointing,pinpointed
pioneer -> pioneers,pioneering,pioneered
pip -> pips,pipping,pipped
pipe -> pipes,piping,piped
pirate -> pirates,pirating,pirated
pirouette -> pirouettes,pirouetting,pirouetted
piss -> pisses,pissing,pissed
pit -> pits,pitting,pitted
pitch -> pitches,pitching,pitched
pity -> pities,pitying,pitied
pivot -> pivots,pivoting,pivoted
placate -> placates,placating,placated
place -> places,placing,placed
plagiarize -> plagiarizes,plagiarizing,plagiarized
plague -> plagues,plaguing,plagued
plain -> plains,plainer,plainest
plait -> plaits,plaiting,plaited
plan -> plans,planning,planned
plane -> planes,planing,planed
plant -> plants,planting,planted
plaster -> plasters,plastering,plastered
plate -> plates,plating,plated
play -> plays,playing,played
play-act -> play-acts,play-acting,play-acted
plead -> pleads,pleading,pleaded,pled
please -> pleases,pleasing,pleased
pleat -> pleats,pleating,pleated
pledge -> pledges,pledging,pledged
plight -> plights,plighting,plighted
plod -> plods,plodding,plodded
plonk -> plonks,plonking,plonked
plop -> plops,plopping,plopped
plot -> plots,plotting,plotted
plough -> ploughs,ploughing,ploughed
pluck -> plucks,plucking,plucked
plug -> plugs,plugging,plugged
plumb -> plumbs,plumbing,plumbed
plume -> plumes,pluming,plumed
plummet -> plummets,plummeting,plummeted
plump -> plumper,plumpest,plumps,plumping,plumped
plunder -> plunders,plundering,plundered
plunge -> plunges,plunging,plunged
plunk -> plunks,plunking,plunked
ply -> plies,plying,plied
poach -> poaches,poaching,poached
pocket -> pockets,pocketing,pocketed
point -> points,pointing,pointed
poison -> poisons,poisoning,poisoned
poke -> pokes,poking,poked
polarize -> polarizes,polarizing,polarized
poleaxe -> poleaxes,poleaxing,poleaxed
police -> polices,policing,policed
polish -> polishes,polishing,polished
politicize -> politicizes,politicizing,politicized
poll -> polls,polling,polled
pollinate -> pollinates,pollinating,pollinated
pollute -> pollutes,polluting,polluted
pommel -> pommels,pommeling,pommeled
ponce -> ponces,poncing,ponced
ponder -> ponders,pondering,pondered
pong -> pongs,ponging,ponged
pontificate -> pontificates,pontificating,pontificated
pooh-pooh -> pooh-poohs,pooh-poohing,pooh-poohed
pool -> pools,pooling,pooled
pop -> pops,popping,popped
popularize -> popularizes,popularizing,popularized
populate -> populates,populating,populated
pore -> pores,poring,pored
portend -> portends,portending,portended
portion -> portions,portioning,portioned
portray -> portrays,portraying,portrayed
pose -> poses,posing,posed
posit -> posits,positing,posited
position -> positions,positioning,positioned
possess -> possesses,possessing,possessed
post -> posts,posting,posted
postdate -> postdates,postdating,postdated
postpone -> postpones,postponing,postponed
postulate -> postulates,postulating,postulated
posture -> postures,posturing,postured
pot -> pots,potting,potted
potter -> potters,pottering,pottered
potty -> potties,pottier,pottiest
pounce -> pounces,pouncing,pounced
pound -> pounds,pounding,pounded
pour -> pours,pouring,poured
pout -> pouts,pouting,pouted
powder -> powders,powdering,powdered
power -> powers,powering,powered
practice -> practices,practicing,practiced
practise -> practises,practising,practised
praise -> praises,praising,praised
prance -> prances,prancing,pranced
prattle -> prattles,prattling,prattled
pray -> prays,praying,prayed
pre-empt -> pre-empts,pre-empting,pre-empted
preach -> preaches,preaching,preached
precede -> precedes,preceding,preceded
precipitate -> precipitates,precipitating,precipitated
preclude -> precludes,precluding,precluded
predate -> predates,predating,predated
predicate -> predicates,predicating,predicated
predict -> predicts,predicting,predicted
predispose -> predisposes,predisposing,predisposed
predominate -> predominates,predominating,predominated
preen -> preens,preening,preened
preface -> prefaces,prefacing,prefaced
prefer -> prefers,preferring,preferred
prefigure -> prefigures,prefiguring,prefigured
preheat -> preheats,preheating,preheated
prejudge -> prejudges,prejudging,prejudged
prejudice -> prejudices,prejudicing,prejudiced
preoccupy -> preoccupies,preoccupying,preoccupied
prepare -> prepares,preparing,prepared
prepay -> prepays,prepaid,prepaying
presage -> presages,presaging,presaged
prescribe -> prescribes,prescribing,prescribed
present -> presents,presenting,presented
preserve -> preserves,preserving,preserved
preset -> presets,presetting,pre-set,pre-sets,pre-setting
preside -> presides,presiding,presided
press -> presses,pressing,pressed
pressgang -> pressgangs,pressganging,pressganged
pressure -> pressures,pressuring,pressured
pressurize -> pressurizes,pressurizing,pressurized
presume -> presumes,presuming,presumed
presuppose -> presupposes,presupposing,presupposed
pretend -> pretends,pretending,pretended
prettify -> prettifies,prettifying,prettified
prevail -> prevails,prevailing,prevailed
prevaricate -> prevaricates,prevaricating,prevaricated
prevent -> prevents,preventing,prevented
prey -> preys,preying,preyed
price -> prices,pricing,priced
prick -> pricks,pricking,pricked
prickle -> prickles,prickling,prickled
pride -> prides,priding,prided
prime -> primes,priming,primed
print -> prints,printing,printed
prise -> prises,prising,prised
privatize -> privatizes,privatizing,privatized
prize -> prizes,prizing,prized
probe -> probes,probing,probed
proceed -> proceeds,proceeding,proceeded
process -> processes,processing,processed
proclaim -> proclaims,proclaiming,proclaimed
procrastinate -> procrastinates,procrastinating,procrastinated
procreate -> procreates,procreating,procreated
procure -> procures,procuring,procured
prod -> prods,prodding,prodded
produce -> produces,producing,produced
profane -> profanes,profaning,profaned
profess -> professes,professing,professed
proffer -> proffers,proffering,proffered
profit -> profits,profiting,profited
program -> programs,programming,programmed
programme -> programmes,programming,programmed
progress -> progresses,progressing,progressed
prohibit -> prohibits,prohibiting,prohibited
project -> projects,projecting,projected
proliferate -> proliferates,proliferating,proliferated
prolong -> prolongs,prolonging,prolonged
promenade -> promenades,promenading,promenaded
promise -> promises,promising,promised
promote -> promotes,promoting,promoted
prompt -> prompts,prompting,prompted
promulgate -> promulgates,promulgating,promulgated
pronounce -> pronounces,pronouncing,pronounced
proofread -> proofreads,proofreading,proof-read,proof-reads,proof-reading
proofreader -> proofreaders,proof-reader,proof-readers
prop -> props,propping,propped
propagandize -> propagandizes,propagandizing,propagandized
propagate -> propagates,propagating,propagated
propel -> propels,propelling,propelled
prophesy -> prophesies,prophesying,prophesied
propitiate -> propitiates,propitiating,propitiated
propose -> proposes,proposing,proposed
proposition -> propositions,propositioning,propositioned
propound -> propounds,propounding,propounded
proscribe -> proscribes,proscribing,proscribed
prosecute -> prosecutes,prosecuting,prosecuted
proselytize -> proselytizes,proselytizing,proselytized
prospect -> prospects,prospecting,prospected
prosper -> prospers,prospering,prospered
prostitute -> prostitutes,prostituting,prostituted
prostrate -> prostrates,prostrating,prostrated
protect -> protects,protecting,protected
protest -> protests,protesting,protested
protrude -> protrudes,protruding,protruded
prove -> proves,proving,proved,proven
provide -> provides,providing,provided
provision -> provisions,provisioning,provisioned
provoke -> provokes,provoking,provoked
prowl -> prowls,prowling,prowled
prune -> prunes,pruning,pruned
pry -> pries,prying,pried
psych -> psychs,psyching,psyched
psychoanalyse -> psychoanalyses,psychoanalysing,psychoanalysed
publicize -> publicizes,publicizing,publicized
publish -> publishes,publishing,published
pucker -> puckers,puckering,puckered
puff -> puffs,puffing,puffed
puke -> pukes,puking,puked
pull -> pulls,pulling,pulled
pulp -> pulps,pulping,pulped
pulsate -> pulsates,pulsating,pulsated
pulse -> pulses,pulsing,pulsed
pulverize -> pulverizes,pulverizing,pulverized
pummel -> pummels,pummelling,pummelled
pump -> pumps,pumping,pumped
pun -> puns,punning,punned
punch -> punches,punching,punched
punctuate -> punctuates,punctuating,punctuated
puncture -> punctures,puncturing,punctured
punish -> punishes,punishing,punished
punt -> punts,punting,punted
purchase -> purchases,purchasing,purchased
puree -> purees,pureeing,pureed
purge -> purges,purging,purged
purify -> purifies,purifying,purified
purl -> purls,purling,purled
purloin -> purloins,purloining,purloined
purport -> purports,purporting,purported
purpose -> purposes,purposing,purposed
purr -> purrs,purring,purred
purse -> purses,pursing,pursed
pursue -> pursues,pursuing,pursued
purvey -> purveys,purveying,purveyed
push -> pushes,pushing,pushed
pussyfoot -> pussyfoots,pussyfooting,pussyfooted
putrefy -> putrefies,putrefying,putrefied
putt -> putts,putting,putted
putter -> putters,puttering,puttered
puzzle -> puzzles,puzzling,puzzled
quack -> quacks,quacking,quacked
quadruple -> quadruples,quadrupling,quadrupled
quaff -> quaffs,quaffing,quaffed
quail -> quails,quailing,quailed
quake -> quakes,quaking,quaked
qualify -> qualifies,qualifying,qualified
quantify -> quantifies,quantifying,quantified
quarantine -> quarantines,quarantining,quarantined
quarrel -> quarrels,quarrelling,quarrelled
quarry -> quarries,quarrying,quarried
quarter -> quarters,quartering,quartered
quash -> quashes,quashing,quashed
quaver -> quavers,quavering,quavered
queer -> queerer,queeres,queers
queer -> queerer,queerest,queers
quell -> quells,quelling,quelled
quench -> quenches,quenching,quenched
query -> queries,querying,queried
quest -> quests,questing,quested
question -> questions,questioning,questioned
queue -> queues,queueing,queued
quibble -> quibbles,quibbling,quibbled
quick-freeze -> quick-freezes,quick-froze,quick-frozen,quick-freezing
quicken -> quickens,quickening,quickened
quiet -> quieter,quietest,quiets,quieting,quieted
quieten -> quietens,quietening,quietened
quip -> quips,quipping,quipped
quit -> quits,quitted,quitting
quiver -> quivers,quivering,quivered
quiz -> quizzes,quizzing,quizzed
quote -> quotes,quoting,quoted
rabbit -> rabbits,rabbiting,rabbited
race -> races,racing,raced
rack -> racks,racking,racked
racket -> rackets,racketing,racketed
radiate -> radiates,radiating,radiated
radicalize -> radicalizes,radicalizing,radicalized
radio -> radios,radioing,radioed
raffle -> raffles,raffling,raffled
rag -> rags,ragging,ragged
rage -> rages,raging,raged
raid -> raids,raiding,raided
rail -> rails,railing,railed
rain -> rains,raining,rained
raise -> raises,raising,raised
rake -> rakes,raking,raked
rally -> rallies,rallying,rallied
ram -> rams,ramming,rammed
ramble -> rambles,rambling,rambled
rampage -> rampages,rampaging,rampaged
range -> ranges,ranging,ranged
rank -> ranks,ranking,ranked
rankle -> rankles,rankling,rankled
ransack -> ransacks,ransacking,ransacked
ransom -> ransoms,ransoming,ransomed
rant -> rants,ranting,ranted
rap -> raps,rapping,rapped
rape -> rapes,raping,raped
rasp -> rasps,rasping,rasped
rat -> rats,ratting,ratted
rate -> rates,rating,rated
ratify -> ratifies,ratifying,ratified
ration -> rations,rationing,rationed
rationalize -> rationalizes,rationalizing,rationalized
rattle -> rattles,rattling,rattled
ravage -> ravages,ravaging,ravaged
rave -> raves,raving,raved
ravish -> ravishes,ravishing,ravished
raze -> razes,razing,razed
re-elect -> re-elects,re-electing,re-elected
re-enact -> re-enacts,re-enacting,re-enacted
re-examine -> re-examines,re-examining,re-examined
re-form -> re-forms,re-forming,re-formed
re-route -> re-routes,re-routing,re-routed
re-use -> re-uses,re-using,re-used
reach -> reaches,reaching,reached
react -> reacts,reacting,reacted
reactivate -> reactivates,reactivating,reactivated
readjust -> readjusts,readjusting,readjusted
ready -> readies,readying,readied
reaffirm -> reaffirms,reaffirming,reaffirmed
realize -> realizes,realizing,realized
reap -> reaps,reaping,reaped
reappear -> reappears,reappearing,reappeared
reappraise -> reappraises,reappraising,reappraised
rear -> rears,rearing,reared
rearm -> rearms,rearming,rearmed
rearrange -> rearranges,rearranging,rearranged
reason -> reasons,reasoning,reasoned
reassemble -> reassembles,reassembling,reassembled
reassert -> reasserts,reasserting,reasserted
reassess -> reassesses,reassessing,reassessed
reassure -> reassures,reassuring,reassured
rebel -> rebels,rebelling,rebelled
rebind -> rebinds,rebound,rebinding
rebound -> rebounds,rebounding,rebounded
rebroadcast -> rebroadcasts,rebroadcasted,rebroadcasting
rebuff -> rebuffs,rebuffing,rebuffed
rebuild -> rebuilds,rebuilding,rebuilt
rebuke -> rebukes,rebuking,rebuked
rebut -> rebuts,rebutting,rebutted
recall -> recalls,recalling,recalled
recant -> recants,recanting,recanted
recap -> recaps,recapping,recapped
recapitulate -> recapitulates,recapitulating,recapitulated
recapture -> recaptures,recapturing,recaptured
recede -> recedes,receding,receded
receive -> receives,receiving,received
recharge -> recharges,recharging,recharged
reciprocate -> reciprocates,reciprocating,reciprocated
recite -> recites,reciting,recited
reckon -> reckons,reckoning,reckoned
reclaim -> reclaims,reclaiming,reclaimed
recline -> reclines,reclining,reclined
recognize -> recognizes,recognizing,recognized
recoil -> recoils,recoiling,recoiled
recollect -> recollects,recollecting,recollected
recommend -> recommends,recommending,recommended
recompense -> recompenses,recompensing,recompensed
reconcile -> reconciles,reconciling,reconciled
recondition -> reconditions,reconditioning,reconditioned
reconnoitre -> reconnoitres,reconnoitring,reconnoitred
reconsider -> reconsiders,reconsidering,reconsidered
reconstitute -> reconstitutes,reconstituting,reconstituted
reconstruct -> reconstructs,reconstructing,reconstructed
record -> records,recording,recorded
recount -> recounts,recounting,recounted
recoup -> recoups,recouping,recouped
recover -> recovers,recovering,recovered
recreate -> recreates,recreating,recreated
recruit -> recruits,recruiting,recruited
rectify -> rectifies,rectifying,rectified
recuperate -> recuperates,recuperating,recuperated
recur -> recurs,recurring,recurred
recycle -> recycles,recycling,recycled
red -> redder,reddest,reds
redden -> reddens,reddening,reddened
redecorate -> redecorates,redecorating,redecorated
redeem -> redeems,redeeming,redeemed
redeploy -> redeploys,redeploying,redeployed
redevelop -> redevelops,redeveloping,redeveloped
redirect -> redirects,redirecting,redirected
redistribute -> redistributes,redistributing,redistributed
redo -> redoes,redoing,redid,redone
redouble -> redoubles,redoubling,redoubled
redress -> redresses,redressing,redressed
reduce -> reduces,reducing,reduced
reek -> reeks,reeking,reeked
reel -> reels,reeling,reeled
refer -> refers,referring,referred
referee -> referees,refereeing,refereed
refill -> refills,refilling,refilled
refine -> refines,refining,refined
refit -> refits,refitting,refitted
reflate -> reflates,reflating,reflated
reflect -> reflects,reflecting,reflected
reforest -> reforests,reforesting,reforested
reform -> reforms,reforming,reformed
refract -> refracts,refracting,refracted
refrain -> refrains,refraining,refrained
refresh -> refreshes,refreshing,refreshed
refrigerate -> refrigerates,refrigerating,refrigerated
refuel -> refuels,refuelling,refuelled
refund -> refunds,refunding,refunded
refurbish -> refurbishes,refurbishing,refurbished
refuse -> refuses,refusing,refused
refute -> refutes,refuting,refuted
regain -> regains,regaining,regained
regale -> regales,regaling,regaled
regard -> regards,regarding,regarded
regenerate -> regenerates,regenerating,regenerated
register -> registers,registering,registered
regress -> regresses,regressing,regressed
regret -> regrets,regretting,regretted
regroup -> regroups,regrouping,regrouped
regularize -> regularizes,regularizing,regularized
regulate -> regulates,regulating,regulated
regurgitate -> regurgitates,regurgitating,regurgitated
rehabilitate -> rehabilitates,rehabilitating,rehabilitated
rehash -> rehashes,rehashing,rehashed
rehear -> rehears,reheard,rehearing
rehearse -> rehearses,rehearsing,rehearsed
rehouse -> rehouses,rehousing,rehoused
reign -> reigns,reigning,reigned
reimburse -> reimburses,reimbursing,reimbursed
rein -> reins,reining,reined
reincarnate -> reincarnates,reincarnating,reincarnated
reinforce -> reinforces,reinforcing,reinforced
reinstate -> reinstates,reinstating,reinstated
reissue -> reissues,reissuing,reissued
reiterate -> reiterates,reiterating,reiterated
reject -> rejects,rejecting,rejected
rejoice -> rejoices,rejoicing,rejoiced
rejoin -> rejoins,rejoining,rejoined
rejuvenate -> rejuvenates,rejuvenating,rejuvenated
rekindle -> rekindles,rekindling,rekindled
relapse -> relapses,relapsing,relapsed
relate -> relates,relating,related
relax -> relaxes,relaxing,relaxed
relay -> relays,relaying,relayed,relaid
release -> releases,releasing,released
relegate -> relegates,relegating,relegated
relent -> relents,relenting,relented
relieve -> relieves,relieving,relieved
relinquish -> relinquishes,relinquishing,relinquished
relish -> relishes,relishing,relished
relive -> relives,reliving,relived
reload -> reloads,reloading,reloaded
relocate -> relocates,relocating,relocated
rely -> relies,relying,relied
remain -> remains,remaining,remained
remake -> remakes,remaking,remade
remand -> remands,remanding,remanded
remark -> remarks,remarking,remarked
remarry -> remarries,remarrying,remarried
remedy -> remedies,remedying,remedied
remember -> remembers,remembering,remembered
remind -> reminds,reminding,reminded
reminisce -> reminisces,reminiscing,reminisced
remit -> remits,remitting,remitted
remodel -> remodels,remodelling,remodelled
remonstrate -> remonstrates,remonstrating,remonstrated
remould -> remoulds,remoulding,remoulded
remount -> remounts,remounting,remounted
remove -> removes,removing,removed
rename -> renames,renaming,renamed
rend -> rends,rending,rent
render -> renders,rendering,rendered
renege -> reneges,reneging,reneged
renew -> renews,renewing,renewed
renounce -> renounces,renouncing,renounced
renovate -> renovates,renovating,renovated
rent -> rents,renting,rented
reopen -> reopens,reopening,reopened
reorganize -> reorganizes,reorganizing,reorganized
repair -> repairs,repairing,repaired
repatriate -> repatriates,repatriating,repatriated
repay -> repays,repaying,repaid
repeal -> repeals,repealing,repealed
repeat -> repeats,repeating,repeated
repel -> repels,repelling,repelled
repent -> repents,repenting,repented
rephrase -> rephrases,rephrasing,rephrased
replace -> replaces,replacing,replaced
replay -> replays,replaying,replayed
replenish -> replenishes,replenishing,replenished
replicate -> replicates,replicating,replicated
reply -> replies,replying,replied
repoint -> repoints,repointing,repointed
report -> reports,reporting,reported
repose -> reposes,reposing,reposed
repossess -> repossess,repossessing,repossessed
repot -> repots,repotting,repotted
represent -> represents,representing,represented
repress -> represses,repressing,repressed
reprieve -> reprieves,reprieving,reprieved
reprimand -> reprimands,reprimanding,reprimanded
reprint -> reprints,reprinting,reprinted
reproach -> reproaches,reproaching,reproached
reproduce -> reproduces,reproducing,reproduced
reprove -> reproves,reproving,reproved
repudiate -> repudiates,repudiating,repudiated
repulse -> repulses,repulsing,repulsed
request -> requests,requesting,requested
require -> requires,requiring,required
requisition -> requisitions,requisitioning,requisitioned
requite -> requites,requiting,requited
rerun -> reruns,reran,rerunning
rescind -> rescinds,rescinding,rescinded
rescue -> rescues,rescuing,rescued
research -> researches,researching,researched
reseat -> reseats,reseating,reseated
resell -> resells,reselling,resold
resemble -> resembles,resembling,resembled
resent -> resents,resenting,resented
reserve -> reserves,reserving,reserved
resettle -> resettles,resettling,resettled
reshuffle -> reshuffles,reshuffling,reshuffled
reside -> resides,residing,resided
resign -> resigns,resigning,resigned
resist -> resists,resisting,resisted
resolve -> resolves,resolving,resolved
resonate -> resonates,resonating,resonated
resort -> resorts,resorting,resorted
resound -> resounds,resounding,resounded
respect -> respects,respecting,respected
respire -> respires,respiring,respired
respond -> responds,responding,responded
rest -> rests,resting,rested
restate -> restates,restating,restated
restock -> restocks,restocking,restocked
restore -> restores,restoring,restored
restrain -> restrains,restraining,restrained
restrict -> restricts,restricting,restricted
restructure -> restructures,restructuring,restructured
result -> results,resulting,resulted
resume -> resumes,resuming,resumed
resurface -> resurfaces,resurfacing,resurfaced
resurrect -> resurrects,resurrecting,resurrected
resuscitate -> resuscitates,resuscitating,resuscitated
retail -> retails,retailing,retailed
retain -> retains,retaining,retained
retake -> retakes,retaking,retook,retaken
retaliate -> retaliates,retaliating,retaliated
retard -> retards,retarding,retarded
retch -> retches,retching,retched
retell -> retells,retelling,retold
rethink -> rethinks,rethinking,rethought
retire -> retires,retiring,retired
retort -> retorts,retorting,retorted
retouch -> retouches,retouching,retouched
retrace -> retraces,retracing,retraced
retract -> retracts,retracting,retracted
retreat -> retreats,retreating,retreated
retrieve -> retrieves,retrieving,retrieved
retrogress -> retrogresses,retrogressing,retrogressed
return -> returns,returning,returned
reunite -> reunites,reuniting,reunited
rev -> revs,revving,revved
revalue -> revalues,revaluing,revalued
revamp -> revamps,revamping,revamped
reveal -> reveals,revealing,revealed
revel -> revels,revelling,revelled
revenge -> revenges,revenging,revenged
reverberate -> reverberates,reverberating,reverberated
revere -> reveres,revering,revered
reverse -> reverses,reversing,reversed
revert -> reverts,reverting,reverted
review -> reviews,reviewing,reviewed
revile -> reviles,reviling,reviled
revise -> revises,revising,revised
revisit -> revisits,revisiting,revisited
revitalize -> revitalizes,revitalizing,revitalized
revive -> revives,reviving,revived
revivify -> revivifies,revivifying,revivified
revoke -> revokes,revoking,revoked
revolt -> revolts,revolting,revolted
revolutionize -> revolutionizes,revolutionizing,revolutionized
revolve -> revolves,revolving,revolved
reward -> rewards,rewarding,rewarded
rewind -> rewinds,rewinding,rewound
rewire -> rewires,rewiring,rewired
rework -> reworks,reworking,reworked
rewrite -> rewrites,rewriting,rewrote,rewritten
rhapsodize -> rhapsodizes,rhapsodizing,rhapsodized
rhyme -> rhymes,rhyming,rhymed
rib -> ribs,ribbing,ribbed
rich -> richer,richest,riches
rick -> ricks,ricking,ricked
ricochet -> ricochets,ricocheting,ricocheted
rid -> rids,ridded,ridding
riddle -> riddles,riddling,riddled
ride -> rides,riding,rode,ridden
ridicule -> ridicules,ridiculing,ridiculed
riffle -> riffles,riffling,riffled
rifle -> rifles,rifling,rifled
rig -> rigs,rigging,rigged
right -> rights,righting,righted
rile -> riles,riling,riled
ring -> rings,rang,rung,ringing
rinse -> rinses,rinsing,rinsed
riot -> riots,rioting,rioted
rip -> rips,ripping,ripped
ripen -> ripens,ripening,ripened
riposte -> ripostes,riposting,riposted
ripple -> ripples,rippling,rippled
rise -> rises,rising,rose,risen
risk -> risks,risking,risked
rival -> rivals,rivalling,rivalled
rivet -> rivets,riveting,riveted
roam -> roams,roaming,roamed
roar -> roars,roaring,roared
roast -> roasts,roasting,roasted
rob -> robs,robbing,robbed
robe -> robes,robing,robed
rock -> rocks,rocking,rocked
rocket -> rockets,rocketing,rocketed
roll -> rolls,rolling,rolled
roller-skate -> roller-skates,roller-skating,roller-skated
romance -> romances,romancing,romanced
romanticize -> romanticizes,romanticizing,romanticized
romp -> romps,romping,romped
roof -> roofs,roofing,roofed
rook -> rooks,rooking,rooked
room -> rooms,rooming,roomed
roost -> roosts,roosting,roosted
root -> roots,rooting,rooted
rope -> ropes,roping,roped
rot -> rots,rotting,rotted
rotate -> rotates,rotating,rotated
rouge -> rouges,rougeing,rouged
rough -> rougher,roughest,roughs,roughing,roughed
roughen -> roughens,roughening,roughened
round -> rounder,roundest,rounds,rounding,rounded
rouse -> rouses,rousing,roused
rout -> routs,routing,routed
route -> routes,routing,routed
rove -> roves,roving,roved
row -> rows,rowing,rowed
rowdy -> rowdier,rowdiest,rowdies
rub -> rubs,rubbing,rubbed
rubber-stamp -> rubber-stamps,rubber-stamping,rubber-stamped
rubbish -> rubbishes,rubbishing,rubbished
ruck -> rucks,rucking,rucked
rue -> rues,ruing,rued
ruffle -> ruffles,ruffling,ruffled
ruin -> ruins,ruining,ruined
rule -> rules,ruling,ruled
rumble -> rumbles,rumbling,rumbled
ruminate -> ruminates,ruminating,ruminated
rummage -> rummages,rummaging,rummaged
rumple -> rumples,rumpling,rumpled
run -> runs,running,ran
rupture -> ruptures,rupturing,ruptured
rush -> rushes,rushing,rushed
rust -> rusts,rusting,rusted
rustle -> rustles,rustling,rustled
sabotage -> sabotages,sabotaging,sabotaged
sack -> sacks,sacking,sacked
sacrifice -> sacrifices,sacrificing,sacrificed
sadden -> saddens,saddening,saddened
saddle -> saddles,saddling,saddled
safe -> safes,safer,safest
safeguard -> safeguards,safeguarding,safeguarded
sag -> sags,sagging,sagged
sail -> sails,sailing,sailed
salaam -> salaams,salaaming,salaamed
salivate -> salivates,salivating,salivated
sally -> sallies,sallying,sallied
salt -> salts,salting,salted
salute -> salutes,saluting,saluted
salvage -> salvages,salvaging,salvaged
salve -> salves,salving,salved
sample -> samples,sampling,sampled
sanctify -> sanctifies,sanctifying,sanctified
sanction -> sanctions,sanctioning,sanctioned
sand -> sands,sanding,sanded
sandbag -> sandbags,sandbagging,sandbagged
sandpaper -> sandpapers,sandpapering,sandpapered
sandwich -> sandwiches,sandwiching,sandwiched
sap -> saps,sapping,sapped
satiate -> satiates,satiating,satiated
satirize -> satirizes,satirizing,satirized
satisfy -> satisfies,satisfying,satisfied
saturate -> saturates,saturating,saturated
saunter -> saunters,sauntering,sauntered
saute -> sautes,sauteing,sauteed
savage -> savages,savaging,savaged
save -> saves,saving,saved
savour -> savours,savouring,savoured
saw -> saws,sawing,sawed,sawn
say -> says,saying,said
scald -> scalds,scalding,scalded
scale -> scales,scaling,scaled
scalp -> scalps,scalping,scalped
scamper -> scampers,scampering,scampered
scan -> scans,scanning,scanned
scandalize -> scandalizes,scandalizing,scandalized
scar -> scars,scarring,scarred
scare -> scares,scaring,scared
scarper -> scarpers,scarpering,scarpered
scatter -> scatters,scattering,scattered
scavenge -> scavenges,scavenging,scavenged
scent -> scents,scenting,scented
schedule -> schedules,scheduling,scheduled
scheme -> schemes,scheming,schemed
school -> schools,schooling,schooled
scoff -> scoffs,scoffing,scoffed
scold -> scolds,scolding,scolded
scoop -> scoops,scooping,scooped
scoot -> scoots,scooting,scooted
scorch -> scorches,scorching,scorched
score -> scores,scoring,scored
scorn -> scorns,scorning,scorned
scotch -> scotches,scotching,scotched
scour -> scours,scouring,scoured
scourge -> scourges,scourging,scourged
scout -> scouts,scouting,scouted
scowl -> scowls,scowling,scowled
scrabble -> scrabbles,scrabbling,scrabbled
scramble -> scrambles,scrambling,scrambled
scrap -> scraps,scrapping,scrapped
scrape -> scrapes,scraping,scraped
scratch -> scratches,scratching,scratched
scrawl -> scrawls,scrawling,scrawled
scream -> screams,screaming,screamed
screech -> screeches,screeching,screeched
screen -> screens,screening,screened
screw -> screws,screwing,screwed
scribble -> scribbles,scribbling,scribbled
scrimp -> scrimps,scrimping,scrimped
scrounge -> scrounges,scrounging,scrounged
scrub -> scrubs,scrubbing,scrubbed
scrunch -> scrunches,scrunching,scrunched
scrutinize -> scrutinizes,scrutinizing,scrutinized
scud -> scuds,scudding,scudded
scuff -> scuffs,scuffing,scuffed
scuffle -> scuffles,scuffling,scuffled
scull -> sculls,sculling,sculled
sculpt -> sculpts,sculpting,sculpted
sculpture -> sculptures,sculpturing,sculptured
scupper -> scuppers,scuppering,scuppered
scurry -> scurries,scurrying,scurried
scuttle -> scuttles,scuttling,scuttled
scythe -> scythes,scything,scythed
seal -> seals,sealing,sealed
sear -> sears,searing,seared
search -> searches,searching,searched
season -> seasons,seasoning,seasoned
seat -> seats,seating,seated
secede -> secedes,seceding,seceded
seclude -> secludes,secluding,secluded
second -> seconds,seconding,seconded
secrete -> secretes,secreting,secreted
secularize -> secularizes,secularizing,secularized
secure -> secures,securing,secured
sedate -> sedates,sedating,sedated
seduce -> seduces,seducing,seduced
see -> sees,seeing,saw,seen
seed -> seeds,seeding,seeded
seek -> seeks,seeking,sought
seem -> seems,seeming,seemed
seep -> seeps,seeping,seeped
seethe -> seethes,seething,seethed
segregate -> segregates,segregating,segregated
seize -> seizes,seizing,seized
select -> selects,selecting,selected
sell -> sells,selling,sold
Sellotape -> Sellotapes,Sellotaping,Sellotaped
send -> sends,sending,sent
sense -> senses,sensing,sensed
sensitize -> sensitizes,sensitizing,sensitized
sentence -> sentences,sentencing,sentenced
sentimentalize -> sentimentalizes,sentimentalizing,sentimentalized
separate -> separates,separating,separated
sequester -> sequesters,sequestering,sequestered
sequestrate -> sequestrates,sequestrating,sequestrated
serenade -> serenades,serenading,serenaded
serialize -> serializes,serializing,serialized
sermonize -> sermonizes,sermonizing,sermonized
serve -> serves,serving,served
service -> services,servicing,serviced
settle -> settles,settling,settled
sever -> severs,severing,severed
sew -> sews,sewing,sewed,sewn
sex -> sexes,sexing,sexed
shack -> shacks,shacking,shacked
shackle -> shackles,shackling,shackled
shade -> shades,shading,shaded
shadow -> shadows,shadowing,shadowed
shag -> shags,shagging,shagged
shake -> shakes,shaking,shook,shaken
shallow -> shallower,shallowest,shallows
sham -> shams,shamming,shammed
shamble -> shambles,shambling,shambled
shame -> shames,shaming,shamed
shampoo -> shampoos,shampooing,shampooed
shape -> shapes,shaping,shaped
share -> shares,sharing,shared
sharp -> sharper,sharpest,sharps
sharpen -> sharpens,sharpening,sharpened
shatter -> shatters,shattering,shattered
shave -> shaves,shaved,shaven,shaving
shear -> shears,shearing,sheared,shorn
sheathe -> sheathes,sheathing,sheathed
sheer -> sheers,sheering,sheered
sheet -> sheets,sheeting,sheeted
shell -> shells,shelling,shelled
shelter -> shelters,sheltering,sheltered
shelve -> shelves,shelving,shelved
shepherd -> shepherds,shepherding,shepherded
shield -> shields,shielding,shielded
shift -> shifts,shifting,shifted
shilly-shally -> shilly-shallies,shilly-shallying,shilly-shallied
shimmer -> shimmers,shimmering,shimmered
shin -> shins,shinning,shinned
shine -> shines,shining,shone,shined
ship -> ships,shipping,shipped
shirk -> shirks,shirking,shirked
shit -> shits,shitting,shat
shiver -> shivers,shivering,shivered
shock -> shocks,shocking,shocked
shoe -> shoes,shod,shodden,shoeing
shoo -> shoos,shooing,shooed
shoot -> shoots,shooting,shot
shop -> shops,shopping,shopped
shore -> shores,shoring,shored
short -> shorter,shortest,shorts
short-change -> short-changes,short-changing,short-changed
short-circuit -> short-circuits,short-circuiting,short-circuited
short-list -> short-lists,short-listing,short-listed
short-weight -> short-weights,short-weighting,short-weighted
shorten -> shortens,shortening,shortened
shoulder -> shoulders,shouldering,shouldered
shout -> shouts,shouting,shouted
shove -> shoves,shoving,shoved
shovel -> shovels,shovelling,shovelled
show -> shows,showing,showed,shown
shower -> showers,showering,showered
shred -> shreds,shredding,shredded
shriek -> shrieks,shrieking,shrieked
shrill -> shriller,shrillest,shrills,shrilling,shrilled
shrink -> shrinks,shrank,shrunk,shrunken,shrinking
shrivel -> shrivels,shrivelling,shrivelled
shroud -> shrouds,shrouding,shrouded
shrug -> shrugs,shrugging,shrugged
shudder -> shudders,shuddering,shuddered
shuffle -> shuffles,shuffling,shuffled
shun -> shuns,shunning,shunned
shunt -> shunts,shunting,shunted
shush -> shushes,shushing,shushed
shuttle -> shuttles,shuttling,shuttled
shy -> shyer,shyest,shies,shying,shied
sicken -> sickens,sickening,sickened
side -> sides,siding,sided
sidestep -> sidesteps,sidestepping,sidestepped
sidetrack -> sidetracks,sidetracking,sidetracked
sidle -> sidles,sidling,sidled
sieve -> sieves,sieving,sieved
sift -> sifts,sifting,sifted
sigh -> sighs,sighing,sighed
sight -> sights,sighting,sighted
sign -> signs,signing,signed
signal -> signals,signalling,signalled
signify -> signifies,signifying,signified
signpost -> signposts,signposting,signposted
silence -> silences,silencing,silenced
silt -> silts,silting,silted
simmer -> simmers,simmering,simmered
simper -> simpers,simpering,simpered
simplify -> simplifies,simplifying,simplified
simulate -> simulates,simulating,simulated
simulcast -> simulcasts,simulcasted,simulcasting
sin -> sins,sinning,sinned
sing -> sings,singing,sang,sung
singe -> singes,singeing,singed
single -> singles,singling,singled
sink -> sinks,sank,sunk,sunken,sinking
sip -> sips,sipping,sipped
siphon -> siphons,siphoning,siphoned
sire -> sires,siring,sired
sit -> sits,sitting,sat
site -> sites,siting,sited
situate -> situates,situating,situated
size -> sizes,sizing,sized
sizzle -> sizzles,sizzling,sizzled
skate -> skates,skating,skated
sketch -> sketches,sketching,sketched
skew -> skews,skewing,skewed
skewer -> skewers,skewering,skewered
ski -> skis,skiing,skied
skid -> skids,skidding,skidded
skim -> skims,skimming,skimmed
skimp -> skimps,skimping,skimped
skin -> skins,skinning,skinned
skip -> skips,skipping,skipped
skirmish -> skirmishes,skirmishing,skirmished
skirt -> skirts,skirting,skirted
skitter -> skitters,skittering,skittered
skive -> skives,skiving,skived
skulk -> skulks,skulking,skulked
slack -> slacker,slackest,slacks,slacking,slacked
slacken -> slackens,slackening,slackened
slag -> slags,slagging,slagged
slake -> slakes,slaking,slaked
slam -> slams,slamming,slammed
slander -> slanders,slandering,slandered
slant -> slants,slanting,slanted
slap -> slaps,slapping,slapped
slash -> slashes,slashing,slashed
slate -> slates,slating,slated
slaughter -> slaughters,slaughtering,slaughtered
slave -> slaves,slaving,slaved
slaver -> slavers,slavering,slavered
slay -> slays,slaying,slew,slain
sled -> sleds,sledding,sledded
sledge -> sledges,sledging,sledged
sleep -> sleeps,sleeping,slept
sleepwalk -> sleepwalks,sleepwalking,sleepwalked
sleet -> sleets,sleeting,sleeted
slew -> slews,slewing,slewed
slice -> slices,slicing,sliced
slick -> slicker,slickest,slicks,slicking,slicked
slide -> slides,sliding,slid
slight -> slighter,slightest,slights,slighting,slighted
slim -> slimmer,slimmest,slims,slimming,slimmed
sling -> slings,slinging,slung
slink -> slinks,slinking,slunk
slip -> slips,slipping,slipped
slither -> slithers,slithering,slithered
slobber -> slobbers,slobbering,slobbered
slog -> slogs,slogging,slogged
slop -> slops,slopping,slopped
slope -> slopes,sloping,sloped
slosh -> sloshes,sloshing,sloshed
slot -> slots,slotting,slotted
slouch -> slouches,slouching,slouched
slough -> sloughs,sloughing,sloughed
slow -> slower,slowest,slows,slowing,slowed
slug -> slugs,slugging,slugged
sluice -> sluices,sluicing,sluiced
slum -> slums,slumming,slummed
slumber -> slumbers,slumbering,slumbered
slump -> slumps,slumping,slumped
slur -> slurs,slurring,slurred
slurp -> slurps,slurping,slurped
smack -> smacks,smacking,smacked
small -> smaller,smallest,smalls
smart -> smarter,smartest,smarts,smarting,smarted
smarten -> smartens,smartening,smartened
smash -> smashes,smashing,smashed
smear -> smears,smearing,smeared
smell -> smells,smelling,smelled,smelt
smelt -> smelts,smelting,smelted
smile -> smiles,smiling,smiled
smirk -> smirks,smirking,smirked
smite -> smites,smiting,smote,smitten
smoke -> smokes,smoking,smoked
smooch -> smooches,smooching,smooched
smooth -> smoother,smoothest,smooths,smoothing,smoothed
smother -> smothers,smothering,smothered
smoulder -> smoulders,smouldering,smouldered
smudge -> smudges,smudging,smudged
smuggle -> smuggles,smuggling,smuggled
snag -> snags,snagging,snagged
snake -> snakes,snaking,snaked
snap -> snaps,snapping,snapped
snare -> snares,snaring,snared
snarl -> snarls,snarling,snarled
snatch -> snatches,snatching,snatched
sneak -> sneaks,sneaking,sneaked
sneer -> sneers,sneering,sneered
sneeze -> sneezes,sneezing,sneezed
snick -> snicks,snicking,snicked
snicker -> snickers,snickering,snickered
sniff -> sniffs,sniffing,sniffed
sniffle -> sniffles,sniffling,sniffled
snigger -> sniggers,sniggering,sniggered
snip -> snips,snipping,snipped
snipe -> snipes,sniping,sniped
snitch -> snitches,snitching,snitched
snivel -> snivels,snivelling,snivelled
snog -> snogs,snogging,snogged
snooker -> snookers,snookering,snookered
snoop -> snoops,snooping,snooped
snooze -> snoozes,snoozing,snoozed
snore -> snores,snoring,snored
snorkel -> snorkels,snorkelling,snorkelled
snort -> snorts,snorting,snorted
snow -> snows,snowing,snowed
snowball -> snowballs,snowballing,snowballed
snub -> snubs,snubbing,snubbed
snuff -> snuffs,snuffing,snuffed
snuffle -> snuffles,snuffling,snuffled
snug -> snugger,snuggest,snugs
snuggle -> snuggles,snuggling,snuggled
soak -> soaks,soaking,soaked
soap -> soaps,soaping,soaped
soar -> soars,soaring,soared
sob -> sobs,sobbing,sobbed
sober -> soberer,soberest,sobers,sobering,sobered
socialize -> socializes,socializing,socialized
sock -> socks,socking,socked
soft-pedal -> soft-pedals,soft-pedalling,soft-pedalled
soft-soap -> soft-soaps,soft-soaping,soft-soaped
soften -> softens,softening,softened
soil -> soils,soiling,soiled
solder -> solders,soldering,soldered
soldier -> soldiers,soldiering,soldiered
sole -> soles,soling,soled
solicit -> solicits,soliciting,solicited
solidify -> solidifies,solidifying,solidified
solve -> solves,solving,solved
somersault -> somersaults,somersaulting,somersaulted
soothe -> soothes,soothing,soothed
sop -> sops,sopping,sopped
sorrow -> sorrows,sorrowing,sorrowed
sort -> sorts,sorting,sorted
sough -> soughs,soughing,soughed
sound -> sounds,sounding,sounded,sounder,soundest
soundproof -> soundproofs,soundproofing,soundproofed
soup -> soups,souping,souped
sour -> sours,souring,soured
sow -> sows,sowing,sowed,sown
space -> spaces,spacing,spaced
span -> spans,spanning,spanned
spangle -> spangles,spangling,spangled
spank -> spanks,spanking,spanked
spar -> spars,sparring,sparred
spare -> spares,sparing,spared
spark -> sparks,sparking,sparked
sparkle -> sparkles,sparkling,sparkled
spatter -> spatters,spattering,spattered
spawn -> spawns,spawning,spawned
spay -> spays,spaying,spayed
speak -> speaks,spoke,spake,spoken,speaking
spear -> spears,spearing,speared
spearhead -> spearheads,spearheading,spearheaded
specialize -> specializes,specializing,specialized
specify -> specifies,specifying,specified
speckle -> speckles,speckling,speckled
speculate -> speculates,speculating,speculated
speed -> speeds,speeding,sped,speeded
spell -> spells,spelling,spelled,spelt
spellbind -> spellbinds,spellbound,spellbinding
spend -> spends,spending,spent
spew -> spews,spewing,spewed
spice -> spices,spicing,spiced
spike -> spikes,spiking,spiked
spill -> spills,spilling,spilled,spilt
spin -> spins,spinning,spun
spin-dry -> spin-dries,spin-drying,spin-dried,spun,dry
spiral -> spirals,spiralling,spiralled
spirit -> spirits,spiriting,spirited
spit -> spits,spitting,spat
splash -> splashes,splashing,splashed
splatter -> splatters,splattering,splattered
splay -> splays,splaying,splayed
splice -> splices,splicing,spliced
splinter -> splinters,splintering,splintered
splurge -> splurges,splurging,splurged
splutter -> splutters,spluttering,spluttered
spoil -> spoils,spoiling,spoiled,spoilt
sponge -> sponges,sponging,sponged
sponsor -> sponsors,sponsoring,sponsored
spoof -> spoofs,spoofing,spoofed
spook -> spooks,spooking,spooked
spoon -> spoons,spooning,spooned
spoon-feed -> spoon-feeds,spoon-feeding,spoon-fed
sport -> sports,sporting,sported
spot -> spots,spotting,spotted
spotlight -> spotlights,spotlighting,spotlighted
spout -> spouts,spouting,spouted
sprain -> sprains,spraining,sprained
sprawl -> sprawls,sprawling,sprawled
spray -> sprays,spraying,sprayed
spring -> springs,springing,sprang,sprung
spring-clean -> spring-cleans,spring-cleaning,spring-cleaned
sprinkle -> sprinkles,sprinkling,sprinkled
sprint -> sprints,sprinting,sprinted
sprout -> sprouts,sprouting,sprouted
spruce -> spruces,sprucing,spruced
spur -> spurs,spurring,spurred
spurn -> spurns,spurning,spurned
spurt -> spurts,spurting,spurted
sputter -> sputters,sputtering,sputtered
spy -> spies,spying,spied
squabble -> squabbles,squabbling,squabbled
squall -> squalls,squalling,squalled
squander -> squanders,squandering,squandered
square -> squares,squaring,squared
squash -> squashes,squashing,squashed
squat -> squats,squatting,squatted
squawk -> squawks,squawking,squawked
squeak -> squeaks,squeaking,squeaked
squeal -> squeals,squealing,squealed
squeeze -> squeezes,squeezing,squeezed
squelch -> squelches,squelching,squelched
squint -> squints,squinting,squinted
squirm -> squirms,squirming,squirmed
squirt -> squirts,squirting,squirted
stab -> stabs,stabbing,stabbed
stabilize -> stabilizes,stabilizing,stabilized
stable -> stables,stabling,stabled
stack -> stacks,stacking,stacked
staff -> staffs,staffing,staffed
stage -> stages,staging,staged
stage-manage -> stage-manages,stage-managing,stage-managed
stagger -> staggers,staggering,staggered
stagnate -> stagnates,stagnating,stagnated
stain -> stains,staining,stained
stake -> stakes,staking,staked
stalk -> stalks,stalking,stalked
stall -> stalls,stalling,stalled
stammer -> stammers,stammering,stammered
stamp -> stamps,stamping,stamped
stampede -> stampedes,stampeding,stampeded
stand -> stands,standing,stood
standardize -> standardizes,standardizing,standardized
staple -> staples,stapling,stapled
star -> stars,starring,starred
starch -> starches,starching,starched
stare -> stares,staring,stared
start -> starts,starting,started
startle -> startles,startling,startled
starve -> starves,starving,starved
stash -> stashes,stashing,stashed
state -> states,stating,stated
station -> stations,stationing,stationed
staunch -> stauncher,staunchest,staunches,staunching,staunched
stave -> staves,stove,staved,staving
stay -> stays,staid,stayed,staying
steady -> steadier,steadiest,steadies,steadying,steadied
steal -> steals,stealing,stole,stolen
steam -> steams,steaming,steamed
steamroller -> steamrollers,steamrollering,steamrollered
steel -> steels,steeling,steeled
steep -> steeper,steepest,steeps,steeping,steeped
steer -> steers,steering,steered
stem -> stems,stemming,stemmed
stencil -> stencils,stencilling,stencilled
step -> steps,stepping,stepped
stereotype -> stereotypes,stereotyping,stereotyped
sterilize -> sterilizes,sterilizing,sterilized
stern -> sterner,sternest,sterns
stew -> stews,stewing,stewed
stick -> sticks,sticking,stuck
stiff -> stiffer,stiffest,stiffs
stiffen -> stiffens,stiffening,stiffened
stifle -> stifles,stifling,stifled
stigmatize -> stigmatizes,stigmatizing,stigmatized
still -> stills,stilling,stilled,stiller,stillest
stimulate -> stimulates,stimulating,stimulated
sting -> stings,stinging,stung
stink -> stinks,stinking,stank,stunk
stipulate -> stipulates,stipulating,stipulated
stir -> stirs,stirring,stirred
stir-fry -> stir-fries,stir-frying,stir-fried
stitch -> stitches,stitching,stitched
stock -> stocks,stocking,stocked
stockpile -> stockpiles,stockpiling,stockpiled
stoke -> stokes,stoking,stoked
stomach -> stomachs,stomaching,stomached
stomp -> stomps,stomping,stomped
stone -> stones,stoning,stoned
stonewall -> stonewalls,stonewalling,stonewalled
stoop -> stoops,stooping,stooped
stop -> stops,stopping,stopped
store -> stores,storing,stored
storm -> storms,storming,stormed
stout -> stouter,stoutest,stouts
stow -> stows,stowing,stowed
straddle -> straddles,straddling,straddled
strafe -> strafes,strafing,strafed
straggle -> straggles,straggling,straggled
straighten -> straightens,straightening,straightened
strain -> strains,straining,strained
strand -> strands,stranding,stranded
strangle -> strangles,strangling,strangled
strap -> straps,strapping,strapped
stray -> strays,straying,strayed
streak -> streaks,streaking,streaked
stream -> streams,streaming,streamed
streamline -> streamlines,streamlining,streamlined
strengthen -> strengthens,strengthening,strengthened
stress -> stresses,stressing,stressed
stretch -> stretches,stretching,stretched
strew -> strews,strewing,strewed,strewn
stride -> strides,strode,stridden,strid,striding
strike -> strikes,struck,stricken,striking
string -> strings,stringing,strung
strip -> strips,stripping,stripped
strive -> strives,striving,strove,striven
stroke -> strokes,stroking,stroked
stroll -> strolls,strolling,strolled
structure -> structures,structuring,structured
struggle -> struggles,struggling,struggled
strum -> strums,strumming,strummed
strut -> struts,strutting,strutted
stub -> stubs,stubbing,stubbed
study -> studies,studying,studied
stuff -> stuffs,stuffing,stuffed
stultify -> stultifies,stultifying,stultified
stumble -> stumbles,stumbling,stumbled
stump -> stumps,stumping,stumped
stun -> stuns,stunning,stunned
stunt -> stunts,stunting,stunted
stupefy -> stupefies,stupefying,stupefied
stutter -> stutters,stuttering,stuttered
style -> styles,styling,styled
stymie -> stymies,stymieing,stymied
subcontract -> subcontracts,subcontracting,subcontracted
subdivide -> subdivides,subdividing,subdivided
subdue -> subdues,subduing,subdued
subject -> subjects,subjecting,subjected
subjugate -> subjugates,subjugating,subjugated
sublimate -> sublimates,sublimating,sublimated
submerge -> submerges,submerging,submerged
submit -> submits,submitting,submitted
subordinate -> subordinates,subordinating,subordinated
subpoena -> subpoenas,subpoenaing,subpoenaed
subscribe -> subscribes,subscribing,subscribed
subside -> subsides,subsiding,subsided
subsidize -> subsidizes,subsidizing,subsidized
subsist -> subsists,subsisting,subsisted
substantiate -> substantiates,substantiating,substantiated
substitute -> substitutes,substituting,substituted
subsume -> subsumes,subsuming,subsumed
subtract -> subtracts,subtracting,subtracted
subvert -> subverts,subverting,subverted
succeed -> succeeds,succeeding,succeeded
succour -> succours,succouring,succoured
succumb -> succumbs,succumbing,succumbed
suck -> sucks,sucking,sucked
suckle -> suckles,suckling,suckled
sue -> sues,suing,sued
suffer -> suffers,suffering,suffered
suffice -> suffices,sufficing,sufficed
suffocate -> suffocates,suffocating,suffocated
suffuse -> suffuses,suffusing,suffused
sugar -> sugars,sugaring,sugared
suggest -> suggests,suggesting,suggested
suit -> suits,suiting,suited
sulk -> sulks,sulking,sulked
sully -> sullies,sullying,sullied
sum -> sums,summing,summed
summarize -> summarizes,summarizing,summarized
summon -> summons,summoning,summoned
summons -> summonses,summonsing,summonsed
sun -> suns,sunning,sunned
sunbathe -> sunbathes,sunbathing,sunbathed
sunburn -> sunburns,sunburned,sunburnt,sunburning
sup -> sups,supping,supped
superimpose -> superimposes,superimposing,superimposed
superintend -> superintends,superintending,superintended
supersede -> supersedes,superseding,superseded
supervise -> supervises,supervising,supervised
supplant -> supplants,supplanting,supplanted
supplement -> supplements,supplementing,supplemented
supply -> supplies,supplying,supplied
support -> supports,supporting,supported
suppose -> supposes,supposing,supposed
suppress -> suppresses,suppressing,suppressed
suppurate -> suppurates,suppurating,suppurated
surf -> surfs,surfing,surfed
surface -> surfaces,surfacing,surfaced
surge -> surges,surging,surged
surmise -> surmises,surmising,surmised
surmount -> surmounts,surmounting,surmounted
surpass -> surpasses,surpassing,surpassed
surprise -> surprises,surprising,surprised
surrender -> surrenders,surrendering,surrendered
surround -> surrounds,surrounding,surrounded
survey -> surveys,surveying,surveyed
survive -> survives,surviving,survived
suspect -> suspects,suspecting,suspected
suspend -> suspends,suspending,suspended
suss -> susses,sussing,sussed
sustain -> sustains,sustaining,sustained
swab -> swabs,swabbing,swabbed
swaddle -> swaddles,swaddling,swaddled
swagger -> swaggers,swaggering,swaggered
swallow -> swallows,swallowing,swallowed
swamp -> swamps,swamping,swamped
swank -> swanks,swanking,swanked
swap -> swaps,swapping,swapped
swarm -> swarms,swarming,swarmed
swat -> swats,swatting,swatted
swathe -> swathes,swathing,swathed
sway -> sways,swaying,swayed
swear -> swears,swearing,swore,sworn
sweat -> sweats,sweating,sweated
sweep -> sweeps,sweeping,swept
sweet -> sweets,sweeter,sweetest
sweeten -> sweetens,sweetening,sweetened
swell -> swells,swelling,swelled,swollen
swelter -> swelters,sweltering,sweltered
swerve -> swerves,swerving,swerved
swift -> swifter,swiftest,swifts
swig -> swigs,swigging,swigged
swill -> swills,swilling,swilled
swim -> swims,swimming,swam,swum
swindle -> swindles,swindling,swindled
swing -> swings,swinging,swung
swipe -> swipes,swiping,swiped
swirl -> swirls,swirling,swirled
swish -> swishes,swishing,swished
switch -> switches,switching,switched
swivel -> swivels,swivelling,swivelled
swoon -> swoons,swooning,swooned
swoop -> swoops,swooping,swooped
swot -> swots,swotting,swotted
symbolize -> symbolizes,symbolizing,symbolized
sympathize -> sympathizes,sympathizing,sympathized
synchronize -> synchronizes,synchronizing,synchronized
syncopate -> syncopates,syncopating,syncopated
syndicate -> syndicates,syndicating,syndicated
synthesize -> synthesizes,synthesizing,synthesized
syringe -> syringes,syringing,syringed
systematize -> systematizes,systematizing,systematized
table -> tables,tabling,tabled
tabulate -> tabulates,tabulating,tabulated
tack -> tacks,tacking,tacked
tackle -> tackles,tackling,tackled
tag -> tags,tagging,tagged
tail -> tails,tailing,tailed
tailor -> tailors,tailoring,tailored
taint -> taints,tainting,tainted
take -> takes,taking,took,taken
talk -> talks,talking,talked
tally -> tallies,tallying,tallied
tame -> tames,taming,tamed,tamer,tamest
tamp -> tamps,tamping,tamped
tamper -> tampers,tampering,tampered
tan -> tans,tanning,tanned
tangle -> tangles,tangling,tangled
tango -> tangos,tangoing,tangoed
tantalize -> tantalizes,tantalizing,tantalized
tap -> taps,tapping,tapped
tape -> tapes,taping,taped
tape-record -> tape-records,tape-recording,tape-recorded
taper -> tapers,tapering,tapered
tar -> tars,tarring,tarred
target -> targets,targeting,targeted
tarnish -> tarnishes,tarnishing,tarnished
tarry -> tarries,tarrying,tarried
tart -> tarts,tarting,tarted,tarter,tartest
taste -> tastes,tasting,tasted
tattoo -> tattoos,tattooing,tattooed
taunt -> taunts,taunting,taunted
tauten -> tautens,tautening,tautened
tax -> taxes,taxing,taxed
taxi -> taxis,taxiing,taxied
teach -> teaches,teaching,taught
team -> teams,teaming,teamed
tear -> tears,tearing,tore,torn
tease -> teases,teasing,teased
tee -> tees,teeing,teed
teem -> teems,teeming,teemed
teeter -> teeters,teetering,teetered
teethe -> teethes,teething,teethed
telecast -> telecasts,telecasted,telecasting
telegraph -> telegraphs,telegraphing,telegraphed
telephone -> telephones,telephoning,telephoned
telescope -> telescopes,telescoping,telescoped
televise -> televises,televising,televised
telex -> telexes,telexing,telexed
tell -> tells,telling,told
temper -> tempers,tempering,tempered
temporize -> temporizes,temporizing,temporized
tempt -> tempts,tempting,tempted
tend -> tends,tending,tended
tender -> tenderest,tenders,tendering,tendered
tenderize -> tenderizes,tenderizing,tenderized
tense -> tenser,tensest,tenses,tensing,tensed
term -> terms,terming,termed
terminate -> terminates,terminating,terminated
terrify -> terrifies,terrifying,terrified
terrorize -> terrorizes,terrorizing,terrorized
test -> tests,testing,tested
testify -> testifies,testifying,testified
tether -> tethers,tethering,tethered
thank -> thanks,thanking,thanked
thatch -> thatches,thatching,thatched
thaw -> thaws,thawing,thawed
theorize -> theorizes,theorizing,theorized
thicken -> thickens,thickening,thickened
thin -> thinner,thinnest,thins,thinning,thinned
think -> thinks,thinking,thought
thirst -> thirsts,thirsting,thirsted
thrash -> thrashes,thrashing,thrashed
thread -> threads,threading,threaded
threaten -> threatens,threatening,threatened
thresh -> threshes,threshing,threshed
thrill -> thrills,thrilling,thrilled
thrive -> thrives,throve,thrived,thriven,thriving
throb -> throbs,throbbing,throbbed
throng -> throngs,thronging,thronged
throttle -> throttles,throttling,throttled
throw -> throws,throwing,threw,thrown
thrum -> thrums,thrumming,thrummed
thud -> thuds,thudding,thudded
thumb -> thumbs,thumbing,thumbed
thump -> thumps,thumping,thumped
thunder -> thunders,thundering,thundered
thwack -> thwacks,thwacking,thwacked
thwart -> thwarts,thwarting,thwarted
tick -> ticks,ticking,ticked
tickle -> tickles,tickling,tickled
tide -> tides,tiding,tided
tidy -> tidier,tidiest,tidies,tidying,tidied
tie -> ties,tying,tied
tie-dye -> tie-dyes,tie-dyeing,tie-dyed
tight -> tighter,tightest,tights
tighten -> tightens,tightening,tightened
tile -> tiles,tiling,tiled
till -> tills,tilling,tilled
tilt -> tilts,tilting,tilted
time -> times,timing,timed
time -> times,timing,timed
time -> times,timing,timed
time -> times,timing,timed
time -> times,timing,timed
timetable -> timetables,timetabling,timetabled
ting -> tings,tinging,tinged
tinge -> tinges,tingeing,tinged
tingle -> tingles,tingling,tingled
tinker -> tinkers,tinkering,tinkered
tinkle -> tinkles,tinkling,tinkled
tint -> tints,tinted,tinting
tip -> tips,tipping,tipped
tipple -> tipples,tippling,tippled
tiptoe -> tiptoes,tiptoeing,tiptoed
tire -> tires,tiring,tired
titillate -> titillates,titillating,titillated
titter -> titters,tittering,tittered
toast -> toasts,toasting,toasted
toboggan -> toboggans,tobogganing,tobogganed
toddle -> toddles,toddling,toddled
toe -> toes,toeing,toed
toil -> toils,toiling,toiled
toilet-train -> toilet-trains,toilet-training,toilet-trained
tolerate -> tolerates,tolerating,tolerated
toll -> tolls,tolling,tolled
tone -> tones,toning,toned
toot -> toots,tooting,tooted
tootle -> tootles,tootling,tootled
top -> tops,topping,topped
topple -> topples,toppling,toppled
torment -> torments,tormenting,tormented
torpedo -> torpedoes,torpedoing,torpedoed
torture -> tortures,torturing,tortured
toss -> tosses,tost,tossed,tossing
tot -> tots,totting,totted
total -> totals,totalling,totalled
tote -> totes,toting,toted
totter -> totters,tottering,tottered
touch -> touches,touching,touched
touch-type -> touch-types,touch-typing,touch-typed
tough -> tougher,toughest,toughs
toughen -> toughens,toughening,toughened
tour -> tours,touring,toured
tout -> touts,touting,touted
tow -> tows,towing,towed
towel -> towels,towelling,towelled
tower -> towers,towering,towered
toy -> toys,toying,toyed
trace -> traces,tracing,traced
track -> tracks,tracking,tracked
trade -> trades,trading,traded
traduce -> traduces,traducing,traduced
traffic -> traffics,trafficking,trafficked
train -> trains,training,trained
traipse -> traipses,traipsing,traipsed
trammel -> trammels,trammelling,trammelled
tramp -> tramps,tramping,tramped
trample -> tramples,trampling,trampled
tranquillize -> tranquillizes,tranquillizing,tranquillized
transact -> transacts,transacting,transacted
transcend -> transcends,transcending,transcended
transcribe -> transcribes,transcribing,transcribed
transfer -> transfers,transferring,transferred
transfigure -> transfigures,transfiguring,transfigured
transfix -> transfixes,transfixing,transfixed
transform -> transforms,transforming,transformed
transgress -> transgresses,transgressing,transgressed
translate -> translates,translating,translated
transmit -> transmits,transmitting,transmitted
transmute -> transmutes,transmuting,transmuted
transpire -> transpires,transpiring,transpired
transplant -> transplants,transplanting,transplanted
transport -> transports,transporting,transported
transpose -> transposes,transposing,transposed
trap -> traps,trapping,trapped
travel -> travels,travelling,travelled
traverse -> traverses,traversing,traversed
trawl -> trawls,trawling,trawled
tread -> treads,treading,trod,trodden
treasure -> treasures,treasuring,treasured
treat -> treats,treating,treated
treble -> trebles,trebling,trebled
trek -> treks,trekking,trekked
tremble -> trembles,trembling,trembled
trendy -> trendier,trendiest,trendies
trespass -> trespasses,trespassing,trespassed
trick -> tricks,tricking,tricked
trickle -> trickles,trickling,trickled
trifle -> trifles,trifling,trifled
trigger -> triggers,triggering,triggered
trill -> trills,trilling,trilled
trim -> trimmer,trimmest,trims,trimming,trimmed
trip -> trips,tripping,tripped
triple -> triples,tripling,tripled
triumph -> triumphs,triumphing,triumphed
trivialize -> trivializes,trivializing,trivialized
troop -> troops,trooping,trooped
trot -> trots,trotting,trotted
trouble -> troubles,troubling,troubled
trounce -> trounces,trouncing,trounced
truck -> trucks,trucking,trucked
truckle -> truckles,truckling,truckled
trudge -> trudges,trudging,trudged
trump -> trumps,trumping,trumped
trumpet -> trumpets,trumpeting,trumpeted
truncate -> truncates,truncating,truncated
trundle -> trundles,trundling,trundled
truss -> trusses,trussing,trussed
trust -> trusts,trusting,trusted
try -> tries,trying,tried
tuck -> tucks,tucking,tucked
tug -> tugs,tugging,tugged
tumble -> tumbles,tumbling,tumbled
tune -> tunes,tuning,tuned
tunnel -> tunnels,tunnelling,tunnelled
turf -> turves,turfs,turfing,turfed
turn -> turns,turning,turned
tussle -> tussles,tussling,tussled
tut-tut -> tut-tuts,tut-tutting,tut-tutted
tutor -> tutors,tutoring,tutored
twang -> twangs,twanging,twanged
tweak -> tweaks,tweaking,tweaked
tweet -> tweets,tweeting,tweeted
twiddle -> twiddles,twiddling,twiddled
twig -> twigs,twigging,twigged
twine -> twines,twining,twined
twinkle -> twinkles,twinkling,twinkled
twirl -> twirls,twirling,twirled
twist -> twists,twisting,twisted
twitch -> twitches,twitching,twitched
twitter -> twitters,twittering,twittered
type -> types,typing,typed
typewrite -> typewrites,typewrote,typewritten,typewriting
typify -> typifies,typifying,typified
tyrannize -> tyrannizes,tyrannizing,tyrannized
ululate -> ululates,ululating,ululated
umpire -> umpires,umpiring,umpired
unbalance -> unbalances,unbalancing,unbalanced
unbend -> unbends,unbended,unbent,unbending
unbind -> unbinds,unbinding,unbound
unbuckle -> unbuckles,unbuckling,unbuckled
unburden -> unburdens,unburdening,unburdened
unbutton -> unbuttons,unbuttoning,unbuttoned
unchain -> unchains,unchaining,unchained
unclasp -> unclasps,unclasping,unclasped
uncoil -> uncoils,uncoiling,uncoiled
uncork -> uncorks,uncorking,uncorked
uncover -> uncovers,uncovering,uncovered
underbid -> underbids,underbidden,underbidding
underestimate -> underestimates,underestimating,underestimated
undergo -> undergoes,undergoing,underwent,undergone
underlay -> underlays,underlaid,underlaying
underlie -> underlies,underlying,underlay,underlain
underline -> underlines,underlining,underlined
undermine -> undermines,undermining,undermined
underpay -> underpays,underpaid,underpaying
underpin -> underpins,underpinning,underpinned
underplay -> underplays,underplaying,underplayed
underrate -> underrates,underrating,underrated
underscore -> underscores,underscoring,underscored
undersell -> undersells,undersold,underselling
undershoot -> undershoots,undershot,undershooting
understand -> understands,understood,understanding
understate -> understates,understating,understated
understudy -> understudies,understudying,understudied
undertake -> undertakes,undertaking,undertook,undertaken
undervalue -> undervalues,undervaluing,undervalued
underwrite -> underwrites,underwriting,underwrote,underwritten
undo -> undoes,undoing,undid,undone
undraw -> undraws,undrew,undrawn,undrawing
undress -> undresses,undressing,undressed
undulate -> undulates,undulating,undulated
unearth -> unearths,unearthing,unearthed
unfasten -> unfastens,unfastening,unfastened
unfit -> unfits,unfitting,unfitted
unfold -> unfolds,unfolding,unfolded
unfurl -> unfurls,unfurling,unfurled
ungird -> ungirds,ungirt,ungirded,ungirding
unhinge -> unhinges,unhinging,unhinged
unhook -> unhooks,unhooking,unhooked
unify -> unifies,unifying,unified
unionize -> unionizes,unionizing,unionized
unite -> unites,uniting,united
unlearn -> unlearns,unlearning,unlearned,unlearnt
unleash -> unleashes,unleashing,unleashed
unload -> unloads,unloading,unloaded
unlock -> unlocks,unlocking,unlocked
unmake -> unmakes,unmade,unmaking
unman -> unmans,unmanning,unmanned
unmask -> unmasks,unmasking,unmasked
unnerve -> unnerves,unnerving,unnerved
unpack -> unpacks,unpacking,unpacked
unpick -> unpicks,unpicking,unpicked
unplug -> unplugs,unplugging,unplugged
unravel -> unravels,unravelling,unravelled
unroll -> unrolls,unrolling,unrolled
unsaddle -> unsaddles,unsaddling,unsaddled
unsay -> unsays,unsaid,unsaying
unscrew -> unscrews,unscrewing,unscrewed
unseat -> unseats,unseating,unseated
unsettle -> unsettles,unsettling,unsettled
unstick -> unsticks,unsticking,unstuck
unstrap -> unstraps,unstrapping,unstrapped
unstring -> unstrings,unstrung,unstringing
untangle -> untangles,untangling,untangled
untie -> unties,untying,untied
unveil -> unveils,unveiling,unveiled
unwind -> unwinds,unwinding,unwound
unwrap -> unwraps,unwrapping,unwrapped
unzip -> unzips,unzipping,unzipped
up -> ups,upping,upped
upbraid -> upbraids,upbraiding,upbraided
update -> updates,updating,updated
upend -> upends,upending,upended
upgrade -> upgrades,upgrading,upgraded
uphold -> upholds,upholding,upheld
uplift -> uplifts,uplifting,uplifted
uprise -> uprises,uprose,uprisen
uproot -> uproots,uprooting,uprooted
upstage -> upstages,upstaging,upstaged
upsweep -> upsweeps,upswept,upsweeping
urbanize -> urbanizes,urbanizing,urbanized
urge -> urges,urging,urged
urinate -> urinates,urinating,urinated
use -> uses,using,used
usher -> ushers,ushering,ushered
usurp -> usurps,usurping,usurped
utilize -> utilizes,utilizing,utilized
utter -> utters,uttering,uttered
vacate -> vacates,vacating,vacated
vacation -> vacations,vacationing,vacationed
vaccinate -> vaccinates,vaccinating,vaccinated
vacillate -> vacillates,vacillating,vacillated
vacuum -> vacuums,vacuuming,vacuumed
validate -> validates,validating,validated
value -> values,valuing,valued
vamp -> vamps,vamping,vamped
vandalize -> vandalizes,vandalizing,vandalized
vanish -> vanishes,vanishing,vanished
vanquish -> vanquishes,vanquishing,vanquished
vaporize -> vaporizes,vaporizing,vaporized
varnish -> varnishes,varnishing,varnished
vary -> varies,varying,varied
vault -> vaults,vaulting,vaulted
vaunt -> vaunts,vaunting,vaunted
veer -> veers,veering,veered
vegetate -> vegetates,vegetating,vegetated
veil -> veils,veiling,veiled
vend -> vends,vending,vended
venerate -> venerates,venerating,venerated
vent -> vents,venting,vented
ventilate -> ventilates,ventilating,ventilated
venture -> ventures,venturing,ventured
verbalize -> verbalizes,verbalizing,verbalized
verge -> verges,verging,verged
verify -> verifies,verifying,verified
vet -> vets,vetting,vetted
veto -> vetoes,vetoing,vetoed
vex -> vexes,vexing,vexed
vibrate -> vibrates,vibrating,vibrated
victimize -> victimizes,victimizing,victimized
video -> videos,videoing,videoed
vie -> vies,vying,vied
view -> views,viewing,viewed
vilify -> vilifies,vilifying,vilified
vindicate -> vindicates,vindicating,vindicated
violate -> violates,violating,violated
visit -> visits,visiting,visited
visualize -> visualizes,visualizing,visualized
vitiate -> vitiates,vitiating,vitiated
voice -> voices,voicing,voiced
volley -> volleys,volleying,volleyed
volunteer -> volunteers,volunteering,volunteered
vomit -> vomits,vomiting,vomited
vote -> votes,voting,voted
vouch -> vouches,vouching,vouched
vouchsafe -> vouchsafes,vouchsafing,vouchsafed
vow -> vows,vowing,vowed
voyage -> voyages,voyaging,voyaged
waddle -> waddles,waddling,waddled
wade -> wades,wading,waded
waffle -> waffles,waffling,waffled
waft -> wafts,wafting,wafted
wag -> wags,wagging,wagged
wage -> wages,waging,waged
wager -> wagers,wagering,wagered
waggle -> waggles,waggling,waggled
wail -> wails,wailing,wailed
wait -> waits,waiting,waited
waive -> waives,waiving,waived
wake -> wakes,woke,waked,woken,waking
waken -> wakens,wakening,wakened
walk -> walks,walking,walked
wall -> walls,walling,walled
wallop -> wallops,walloping,walloped
wallow -> wallows,wallowing,wallowed
wallpaper -> wallpapers,wallpapering,wallpapered
waltz -> waltzes,waltzing,waltzed
wander -> wanders,wandering,wandered
wane -> wanes,waning,waned
wangle -> wangles,wangling,wangled
wank -> wanks,wanking,wanked
want -> wants,wanting,wanted
war -> wars,warring,warred
warble -> warbles,warbling,warbled
ward -> wards,warding,warded
warm -> warmer,warmest,warms,warming,warmed
warn -> warns,warning,warned
warp -> warps,warping,warped
warrant -> warrants,warranting,warranted
wash -> washes,washing,washed
waste -> wastes,wasting,wasted
watch -> watches,watching,watched
water -> waters,watering,watered
water-ski -> water-skis,water-skiing,water-skied
waterproof -> waterproofs,waterproofing,waterproofed
wave -> waves,waving,waved
waver -> wavers,wavering,wavered
wax -> waxes,waxing,waxed
waylay -> waylays,waylaying,waylaid
weaken -> weakens,weakening,weakened
wean -> weans,weaning,weaned
wear -> wears,wearing,wore,worn
weary -> wearier,weariest,wearies,wearying,wearied
weather -> weathers,weathering,weathered
weave -> wove,weaves,woven,weaved,weaving
wed -> weds,wedding,wedded
wedge -> wedges,wedging,wedged
wee -> wees,weeing,weed
weed -> weeds,weeding,weeded
weep -> weeps,weeping,wept
weigh -> weighs,weighing,weighed
weight -> weights,weighting,weighted
welcome -> welcomes,welcoming,welcomed
weld -> welds,welding,welded
wend -> wends,wending,wended
westernize -> westernizes,westernizing,westernized
wet -> wets,wetted,wetting
whack -> whacks,whacking,whacked
wheedle -> wheedles,wheedling,wheedled
wheel -> wheels,wheeling,wheeled
wheeze -> wheezes,wheezing,wheezed
whelp -> whelps,whelping,whelped
whet -> whets,whetting,whetted
while -> whiles,whiling,whiled
whimper -> whimpers,whimpering,whimpered
whine -> whines,whining,whined
whinge -> whinges,whinging,whinged
whinny -> whinnies,whinnying,whinnied
whip -> whips,whipping,whipped
whirl -> whirls,whirling,whirled
whirr -> whirrs,whirring,whirred
whisk -> whisks,whisking,whisked
whisper -> whispers,whispering,whispered
whistle -> whistles,whistling,whistled
white -> whiter,whitest,whites
whiten -> whitens,whitening,whitened
whitewash -> whitewashes,whitewashing,whitewashed
whittle -> whittles,whittling,whittled
whizz -> whizzes,whizzing,whizzed
whoop -> whoops,whooping,whooped
whoosh -> whooshes,whooshing,whooshed
wide -> wider,widest,wides
widen -> widens,widening,widened
wield -> wields,wielding,wielded
wiggle -> wiggles,wiggling,wiggled
wild -> wilder,wildest,wilds
wilt -> wilts,wilting,wilted
win -> wins,winning,won
wince -> winces,wincing,winced
winch -> winches,winching,winched
wind -> winds,winding,winded,wound
window-shop -> window-shops,window-shopping,window-shopped
wine -> wines,wining,wined
wing -> wings,winging,winged
wink -> winks,winking,winked
winkle -> winkles,winkling,winkled
winnow -> winnows,winnowing,winnowed
winter -> winters,wintering,wintered
wipe -> wipes,wiping,wiped
wire -> wires,wiring,wired
wire-tap -> wire-taps,wire-tapping,wire-tapped
wiredraw -> wiredraws,wiredrew,wiredrawn,wiredrawing
wise -> wiser,wisest,wises,wising,wised
wisecrack -> wisecracks,wisecracking,wisecracked
wish -> wishes,wishing,wished
wit -> wits,wist,wot,witting
withdraw -> withdraws,withdrawing,withdrew,withdrawn
wither -> withers,withering,withered
withhold -> withholds,withholding,withheld
withstand -> withstands,withstanding,withstood
witness -> witnesses,witnessing,witnessed
witter -> witters,wittering,wittered
wobble -> wobbles,wobbling,wobbled
wolf -> wolves,wolfs,wolfing,wolfed
wolf-whistle -> wolf-whistles,wolf-whistling,wolf-whistled
wonder -> wonders,wondering,wondered
woo -> woos,wooing,wooed
woof -> woofs,woofing,woofed
woolly -> woollies,woollier,woolliest
word -> words,wording,worded
work -> works,wrought,worked,working
worm -> worms,worming,wormed
worry -> worries,worrying,worried
worsen -> worsens,worsening,worsened
worship -> worships,worshipping,worshipped
worst -> worsts,worsting,worsted
worthy -> worthier,worthiest,worthies
wound -> wounds,wounding,wounded
wrangle -> wrangles,wrangling,wrangled
wrap -> wraps,wrapt,wrapped,wrapping
wreak -> wreaks,wreaking,wreaked
wreathe -> wreathes,wreathing,wreathed
wreck -> wrecks,wrecking,wrecked
wrench -> wrenches,wrenching,wrenched
wrest -> wrests,wresting,wrested
wrestle -> wrestles,wrestling,wrestled
wriggle -> wriggles,wriggling,wriggled
wring -> wrings,wringing,wrung
wrinkle -> wrinkles,wrinkling,wrinkled
write -> writes,writing,wrote,written
writhe -> writhes,writhing,writhed
wrong -> wrongs,wronging,wronged
wrong-foot -> wrong-foots,wrong-footing,wrong-footed
X-ray -> X-rays,X-raying,X-rayed
Xerox -> Xeroxes,Xeroxing,Xeroxed
yammer -> yammers,yammering,yammered
yank -> yanks,yanking,yanked
yap -> yaps,yapping,yapped
yaw -> yaws,yawing,yawed
yawn -> yawns,yawning,yawned
yearn -> yearns,yearning,yearned
yell -> yells,yelling,yelled
yellow -> yellower,yellowest,yellows,yellowing,yellowed
yelp -> yelps,yelping,yelped
yield -> yields,yielding,yielded
yodel -> yodels,yodelling,yodelled
yoke -> yokes,yoking,yoked
yowl -> yowls,yowling,yowled
zap -> zaps,zapping,zapped
zero -> zeros,zeroes,zeroing,zeroed
zigzag -> zigzags,zigzagging,zigzagged
zip -> zips,zipping,zipped
zoom -> zooms,zooming,zoomed
